MGMGMGWWGMMGWGWWWWWWWGMGMMGWWGWWGWWWGGWWWWWWGWGWWWWWWWGGW
MMMGGWWWWGMMGGGWWGWWGMMGGMMGWGGWGWWGWWGWWGWGGGGGGGWWWGWGG
MMGGWWWWGMMGGGWWWWGGGGMGMMMGGMGGMGGGGGGGWGGWGWGWGGWWGGGWG
MMMGGGWGGMGMGGGGGGMGWGMMMMMMMMGMGGWWWGGGGWWWGWWGGMGWGMGGM
MGGGGGWGGMGMGGGWWGGGGGMMGMGMMMGGWWWGGGWGGGWWWGWWGGMGMGMGM
MGGMMMGGGMMGWWWWWWGMGWGGGGGGMGGGGGWGWWWGGGWWWWGGMMMGMMMMG
GGWGMGGGGGMGGWGGWWGMGWWGWWWWGGGGGGWWGGGGWGWGGGWGGGMMGMMGG
WWWGMMGWWGGWWWGGWGGGGWGGGWWWGGMMMMGGGWGWGWWWWWWGMGMMMGMGW
GGGGMMGGGWGGGWWWGGMGGGWGWWWGGMMMGGMMGWWWGGGGGGWGGGMGMMMGW
WWGGMGWWWGWGWWWGWGGWWWWWWWWWWGMMMGMGGGGWGGGMGMGMMMGGGMGGW
GGWGMGWWGWGWGWWWWWWWGWGWGGGWGMMMGMMGGWGGMMMMGGGMMMMGMMGGG
WWWGGGGWGGWGWWWGGWWGMGGWGGWWGMMGGMGGGGMMMMGMGMGGMMMGMMGWW
WWWGWGGGGWWGGWGWGWGGGGWGMGGGGGGWGMGGMMMGGMMGMMMGGGGWGGWWG
WWWWWGWGGWWWGWWWWGGGWWGWGWWWGGGWGMGGMMMMGMMGGMMGMMMGGWWWW
WWWGGGGWGGGWGWWWGGGMGGGWGGGGWGGWGMMGGMMMMMGMMMGGMMMGMGGGG
WGGGMGWGGWGWGGGGMGMMGGMGGMMGWGGWGGMMMMMMMMMMGMMMMMMMGGGGW
GMMGGGWWGWGGGGMMGMMMGGGWWGGWGMGWGGGMMMMGGMGMGMGGGMGGGWWGG
MMGGGWWWGGWGMGGMMMMGMGGGGMGGGMGGGMGGGMMMGGMGGGWGGMMMMGGWG
MMGWGWGWWWGGMMGGMGMGMGMMGGWWWGWWWGWWGMMMMMMGGWWGGGGMGWGWG
GGGWWGGWGGMMGGMGGGMGMMMMGWWGWGGGGWWGMMMGGMGGWWWGMGGGGGMGW
WWWWWWGWWWGMMMMGMMGGMGGMGGGWWGWWGWWGGGGGWGWGGWWGGGWGMMMGG
GGGWGWWGGGWGGGGMMGMGMGWGGGWWGGWGMGWWWWGMGGWGMGWGGGWGGGGGM
WGWWWGGGWWGGMGMMMMMGGGGMGWGWGWGGGWGGWWGMGGGMGWWGGGWGGGMMM
GGGWGWGGWWWWGGGGMGMMGGMMMGGWWGGWWWGWWGGMMMGGGWWWWGGMMMGGM
GMGWWGGGWGWGGMMGMGGGMGMGGWGGWWWWWWWWWGMGGGWGGGWGWWGMGGMGM
GMMGGGWWWGGGGMGMGWGMGGGGWGWGWWWWWWGWGMGMGGGWWGWGGGGMGWGMM
GMGGWGGGWWWGMMMMGGMGGGWGGGWGWGWGGWWGGMMGGWWGGGWWWGMMMGMMM
MMMGWWGMGWGGMGGMGMMGMGWWGGGWGMGWWGWGGGMMGGWWGMGGGWGGGGMMG
