WGMMMMMGGGMMGMMGMGGGGWWGWGGGWGWGWGMGGMMMGGMMGGGGGWWGWWWGG
GMGMMMMGMGGMMMMMMGMMMGWWWGWGWGWGGGMGMGGGMGGMGWWGWWWGGGWGM
WGGMGGMGGWGGGMMGGGMMGGGGGGGWWWWGMGGMGGMMMMGGGGGWWWWWGGWGG
WWGMGGGGGWGGWGMGWGMGMMMGWWGGWWGGMMMMMGGMGMGMMGWGGWWWWWWGW
GWGMMMGMGGGGWWGWWWGMGMMGWWGWWGGWGGGGMMGGGMGMGWGGMGGWGWGWG
GWGGGMMGMGMMGGGWGWWGWGMGWGWWGGWWWGGWGGWWGMGGMGWGGWGWWWWWW
WWWGGMGMGMMGMGGWGWGGWGMGGGWWGWGGWGGWGWGGMGGGMGGMGGGGWWWWW
WGWGGGWGMMMGMGWGWWGWGGMMGMGGWWWGWWGWWWGMMGGGMGWGGGGWWGGWG
GGGMMGGMMMMMGMGMGGGGGMMGMMMGGGWGGGWWGWGMMGGMMMGGGGWGWGGGM
GMMMGGMMGGGMMGMMMMGGGMGMMGGGWWWWGWWGWWWGMMGMMGMGWWGWWWGWG
MMMMGGGGWWWGMGMMMGGMGGGGMMGMGGWGMGWGWWGGGGGMGWGWWWWGGGWWW
MGGGGGGMGGGGGMGGMMMGGGMGMGGMGWGGGWGWGWWGGMMGGGGWGWWGGGWGG
MGWGMGMGGWWWGGGWGMMMGGMMGGWGWWGWGWWGWGGWWGGMMMGGWWGWWWWWW
MMGGMMMGWGWGWWGGMMMGGGMGWWWWGWWWWWWGWWGWGWWGGMGGGGMGWGWWW
MGGMMGGGGWWGWGMGGMMMMMMMGGGWGWGWWGWWWWWWWWWWWGMMMMMGGMGWG
GMMMMGMGWGWWGMGMMGMMGMGGWGMGGWWWWGGGGGGWWGGGWWGMGMMGGMMGG
MMMMMGGGWWWGMMMMMMMGGMMGGWGGWGGWWWGWWWWGGGMGWWGMMGMGMMMMM
GGGMGWGWWGWGGGGGMMMMMMGGWWWWWGMGWGGWWGWGGMMMGGMGGMMMMMMMG
GMMMGWWWWGGMGMGGGGGMGGMGGWGGWWGWWGWWGGWWWGGGMMMMGGGMGMMMG
GMGMGGGGGGGMMMMMGGGMMGMMMGWWWGMGWWWGGGWWGGWGMMGGWGGMGMMGM
MGMGWWGMGGMGGMMMMMMMMMMGGWWGGGGMGWGGMGWWWWWGGGMGWWGMGMGGM
MMMGGWGMGMMMGMMMMGMMGMGWWGGMGMGGWGMGMGGWGGWGWWGWGGGGGGMGM
MGMMMGMGGMMGMMMMMMGGMMMGGGGGMMMMGGGWGWWWGWGMGGGWGGMMGGMMG
MGGMMGMGMMMMGMMMGGMMGMGMGMMMGGGMGGWWGGWWGGMMGWGGMMMGGWGGW
MMGMMGMMMMGGMMGGMMGGMMMGMGMMMGMMMMGWWWWGWGMMGWGMMMGGMGMGW
MGGMMMGMGGGMGMGMMGWGGGGGGMGMGGMMGMMGWWWGWGGGWGGGGMGMMMMGW
GMMMGMGMMGGMMMGGGWGGWGMMGMMMMGGMGGMGWWGWGWWGWGWGGMGGMGGWW
MMMGMMGGGGWGGGGGWGWGGGMMMGGGMGGGWGMGWWGGGWWWGGGMMMMMMMMGW
