MMMMMGMMMMMMMMMGMMGGWWWGGGGWWWGMGWGGGMMGGWGGMMGGWGMGMGGGW
GMGGMGGMMGGGMGGGGGMGGGGGGGGWWWGGGWWWGGGWGWGGMGMMGMMMGWWGG
GMMMMMMGGGMMMGMMMGMMMMMGWWGGGGMMMGGGGWGWWWGMMMMMMGMGWWGWG
GGGMGMMMGMGMMMMGMMMMMGMGWWGMMMMGGMGMGWWGGGGMGGMGGGMMGGGWW
GMMMGMMGMMMMGMGGMMMGGMMGGWWGMGMMMGMGMGGGGMMMMMMGMGMGMMMGW
MMMMGMGGMMGGGMGGGMMGGMGWGGGGGMMMMGMMMGMGMMMGGMGGGMMMGMGWW
GGMGGMGMGMMMGGGWWGMGGGGWGWGWGGGGMMMGGGMGMGGMGGMGMGMMGGWWW
GMMMGGMMGGGGMGGGGMGGWWWGWWGGMGMMGMMGGGMGMMMMGWGWGGGMMGWGW
MMMMGWGMMMGGMMGGMMMMGGGGWWGGGMMMMMGWWGGMMGGMMGGWWWGMGGWWG
MMMMGGGMMMMGMMGGMGMGWGWGGGGWWGGGGMGWGGGMMMGMMMMGGGGGWGWWW
GMMGGMMMMMGMMGWGGGMGGGWGWWWGGGGMGMMGMMGGGMMGGMMMMGGWWWGGG
WGGGMMMMGGMMGGWGGMMGWGGGGGWGMGGGMGGGMMMMMGMGGGGGMMGWWWGWG
GWGMGMMMGGMGGGGMGGMGGMGGGGGMGGMMMMMMMGGMGMGGMGMMMGGWWGGWW
WGGMMMGGGMMGWGGMGWGGWGWWWWGMMGGGMGMGMGGMGMGWGMMMGGGWWWGGG
GGMMGGGGGGMMGWWGWWGWGWWGWWGGMMGGGMMGGMGMMMGWWGMMMMGGGWGMM
GMMMGWWWGGMGWWWWGWGWGGGWGWGGGGMMMMGWGMMMMGWGWWGMMMGGWWWGG
MMGGWWWGGWGGGWGGMGWWWWGGGGGMMGGMMMMGMGGMMGWWWGMMGGGGGWWWG
MMMMGGGWWGWGWGMMMMGWWWGGWWWGGMMMMGMGMMMMGWWWGGMMMGWGGGWGG
MMMGWWGWWGWWWGGMGGGWWGWGGWGMMMGMGMMGMMMGWGWWGMMGMGGWWWWGG
GGGWGGGWWWGGGMMGGMMGWGGGMGWGMGGMMGMMGGGWWGGGMGMGGGMGGWWWW
GWWWWGWGWWWGWGGWGGGGGWWGGGGGGWGMGWGGMGWWWWWWGGGWGGMGWGWWW
GGWWGGWGWWGGWWWWGWGGGWWWWGGMMGMGGGGMMGGGWWGGGMMGGMMMGWWGW
WWWWGWGWWWWWGWGWWGGGGWWWGGGGGGMMMGMGMMMMGGGGGGMMGGMGMGGWW
GGGGGWWWWGGGWWGGWGWWWGGWGGWGMGGGMMMMMMGGGGMMMMGGGMGGMMGWW
GWGWWWWGGGMMGWGWWWGWGMGWWGWGGGWWGGGGMMMGMGGGMGWWGMGMMGGWG
WWGWGGGWWWGMMGWWGGGWGGWGWWWGGGWWGMMGMGGGMMMGGWGWGGGGGGMGG
GWWGGGWGGGMMGGGWGGWWWWGGGWWWWWWGGMMMMGGGGMMGWWWWGMMMGGGGG
GWGGWWWWGMGGWWWWGMGGGGGMGGGGWGGWGGMGGGMMMGMGWWWWGGGGWWWGW
