GWWWWGGMMGWWGGGGMMMMMGGWGWWGGGWGGWWWWWWWWWWWWWWGGGGGGWWGG
MGGGWWGMGWWWWGGWGGMGMGGWWWWGMGGMGGGGGGGGWGWWWGGGWWWWWGGMG
MGWGGGMGGGGGWGGWWGMGMMGGWWGGMMGMGMMMMMMGGWWGGWGGWWGWGGGMM
GGWGGGMMGGMGGWGWGGMGGGGGWWGGMMGMMGGMMGMGGGWWWGGWGWWGGGMMG
GWWGWWGGWWGWGWWGWGMGGGMGGGGMGGMGMMMMGMMMMMGWGWWWGGGGGGGMG
WWWGWWWGWWWWGGGGGGMGGMGWWGGGWWGGGGGGGMGMMMGGGGGWGMMGGMGMG
GGGMGGWGWWWWGWGMMGMMMMGGWWWWWGGGMGGWGGWGGGMGMGGWGMMGGMMGM
MGGGWGGGGWGGWWGGGMMMMMGMGGWWWGGGGWGGMMGWGGGGGWWGGGGGWGGMM
GWWWWGGMGWGGGGGGMGMGMMMGGGWWGGMMGGMMGMMGMGWWWWWGWWGGWWGGM
GWWWGMMMGGWWGGMMMMGGMMGMMGWGGMMMMMMMGGMGGGGGWGGWWGGGWGGMM
WWWGMGMMMGGGWGMGGMMMMMGGMGGMMGGMMGMMGGGGMMMMGGWWWWWGGMMGG
GWGGGWGMGGWGGMGMMMGMGGMMGMGMGMMMGMGMMMMGGGGMGWWGGWWGWGMGM
WGGMGWWGWWGWWGMMMMMGGWGMMMMMGMGGGGMMMMGGMGMMGWWWGGWWWGMMM
WGWGGWGGWWGGWGMMGMMGGGMGGMMMMMGGWGMMMMMMMGGGMGGGGWGGGGGMG
WWGGGGGGWGMGGGGGGGMMMMGWGMMMGGMGGMMMGMMGGMGWGMMMGWGWGWGMG
WWWGWGGWGGMGMMGMGMGMMGGGGMMGGMMMMMGMMMMMGGWGWGGGWGGGWWGMG
GGWWWWWGMGMMMGGMGGGMGGWGWGGWGGGMGMMMGMMMGGWGGGMGWGWWGGWGM
GWWWGWGMMGGGGMGMGMMMGGWWGWWGGGGGMMGMGGGGGWWWGGMMGWWGGWGGM
GGWWGWWGGWGGMMGMMMGGMMGGGWWWWWWGGGGGGMMGGWWGGGGGWWWGMGWGG
GWWGWGWWWGGGGMMMGMMMGGMMGGGWWGWGGMGGMMMGMGGGGWWWWWWGMMGWW
GWWGWGWGWGGMMGGGMMMGGMMGGWGWGWWGGGGGGMMMGWGWWGGWWGWGMGWGG
GWGWGWGMGGMGMMMMMMGMGMMGWWWGWWGMMMGMMMGGWWWGWGWWGGGGGGGWW
GWWGWGGGMMGMMGMMGMMMGGMGGGWWGGGMMMMMMGWWWWWGWGWWWWWGMGWGW
GGWWGMMGGMGMGGGMGGMGMMMGGGGWWGGGMMGGGGWWWWGGGGGGGWGWGGGWW
GMGWGGGGMMMGMMMGGMMMGMMGWGWWGGGGGGWWGGWGGWGMMMMGGWGWGGGWG
MGWWWWWGGGGWGGGWGMGGMMMGWGWGGWGGGGWGMMGGGGGMMGMGGWWGWWGWW
GGWGWWWGGGWGGWWWGGGGGGGGGGWWGGWWWGGMMMMMMMMGGMMGWWGMGGGGW
WWGGWWWWWGWWGGGWWWWWWWGWWGWGWWWGGMMMGMMMGGMMGMGGGGGGMGWGG
