WWWWGWGGGWWWWGGWGGMMGGGGMMGWWGGWWWGGGGWGWWWWWWWGMGGMMGGGG
GGWWGWWWWWWGGWWWGMMGGMMGGGMGGMGWGWWWWWWWGWWWWWWGMMGMMMMGW
GWWGGWWWGGGMGGWWGGGMMGGMMGMMGGMGWWWWWGGWGGWWGWWGMGGGMGGGG
GGWGGGWWGWGGGGGGGGMMMGGMMGMGWGGWWGWWGWWWGWWGGWWWGMMMMMMGG
GWWWWWGGWWGMMMMMGGGGMGMMGGMGGWGGGWGWGGWWWGGGWWGGGMGGMGMMG
WWWWGGGWGWGGGGGGWWGGGGMMGMGMGGWWWWWGWWWWWWWWGGGWGGMMMMGGM
WGWWWWWWGGGGGWGWWGWWGMMGMMGGWWWWGWGWWWGGGWGWWGGGMMMMMGMMG
WGWGWGGWWWWGGWWGWGGWWGMGGGGWGGGWGWGGWWGWGWWWWGMMMMMMMMMGW
WWWGGMGWWWGGMGGWWWWWGGGWGWGGWGGGGWGWWWWWGWWGGMMMMMGGMGGGW
GGWGGMMGWGGMMGWWGGGWGWWWWWGWWGGGGGWGWGWWWWGMGGMGGMMGGGGWW
GWWWWGMMGMMMGMGGWGWWGWGGWWGWWWWWWGGMGMGGGGGGWWGGGMGMMGWGW
WWWGGGGMGMGGMMMGWWWWWWWGGWWWWWWWGMGMGMGMMGGGGGMMMMGGGWWWW
GWGWGMGMMMMGGGGMGGGGGGWWWWGGGWGGWGGMMMMMMMGMMMMMMMMMGGGWW
WGGGMMGGGGMGGWWGGMGMMGGWWGMMMGMGWGWGMGGGMGMGGMMMMMGGMGGGW
WGGGMGMMMGMMGWWGGMMGGWGWGGMGGMMMGGGGMGMMMGGMGMMMGGGGMGWWW
GWWGGMGMMGMGGGGMGMMMGGMGGMMMGGGMGMMMMGMGMMGGGMGMMMMMMGWGG
GWWGGMGMMMGGMMMGGGMGMMGGWGGGMMMMMGGMMMMGMMMGGGMMMGGMMGWGG
GWWWWGMMGMMGMGGMMGMMGMGGGMMGGGGGMGMMMMMGGGGMGGMMMGWGGGGWG
WGWGGMGMGGGGGMMGGGMGMGWGMGGWGWGWGGGGMMMGGWGGMMGMGGGMGWGGW
WWGWGMMGGMMMMMGMMMMGMMGGMMGGGWGGGWGGMMGWWGWWGGGGWGMMGGWWW
WGWGGMGGMGGGGGWGGMMGMMMGGMMMGWWGGGGGGMGWWWWWWWWGGGMGGGGWW
GGGGGGGMGGGMMGGMMMMMGMGMGMGGGGWWGMGMGGGGWGWGGGGGGMMGWWWWG
WWWWGWWGMMMMMGMGMGGMGGGMMMMMMGGGMMMMMGGWWWWWGWWWGGMMGWGWG
GGWWWGGGMMGGMGGGMGMGMGGMMGMGGMMMMMGGMGGGWWWWGWGGGMMGGGWGG
GWGGWWWGGMMMMMGGMMMMMMMGGGMMMGGMGGMMGGWGGWWWWGMGMGMGMGGGM
WGMMGGWGGGMMGMMMGMMGGGMGMMMMGGGMMMMMGWWWGGWGGGMMMMMGGWGMM
GMGGGMGWGGGGGGGGMGGGGMMMMMGMMMGMGGMGMGGGWGWWWGMGGMMMGWWGM
MGMGGGGGWWGGGWWWGWWWGGGMMGGGMGMGGGGGGWGGWWWWWGMMGMGGWGGGM
