GGGGWGMGGGGGWWWGMMGMMGWGWGWWWWGMMGGWGGWWWGGMGGWGGMGMMMMMM
GWWGWWGWGGGGWWWGGMGMMMGMGMGGWGGGMGWWWWWWWWGGGGGWGGGGGGGMG
WWGWGGMGMMGMGGGMGMMMMGMGGMGMGWGGMGGWWWWGWWGWWWWGGGWGWGGGM
WGGWGMMGMGMMGGMMMMMMMMGMGMMMGGWGMGGWGWGMGGGGWWGGWWWGGWWGG
WWWWGMGGMGGGGMGGMMMGMGMMMMGGGWWGMGGGGWGGMMGGGGWWGWGWGWWGG
WGWGGMMMMMMGGGGGGGGMGGGMGGGGWGWWGGWGGWGGGMMMMGGWGGWWWGWGW
WWGMGMGMMMGMGGMGMMMMMMGMGMGWGWWWWWWWGGMMMMGMGWGGWWWGWWWWW
WGGGMMGMMMMMGGGWGGMGMGWGMGWGWGWGGWWGWGGMMGMMMGMGWWGWWGGGW
GMGGMMMMMGGGGMGGWWGWGWGGGMGMGGWGMGGGGWGGGGMMMMMGWWWGGWGWW
GMMGMMGMMGGWGMGGGGGWWGGGWGGMMGWWGWGMGWGGWGGGGMGMGWGWWWWWG
GGMGGMMMGGMGWGWGWGWWWWWWGMGGGGGGGWGGWWWWWWWWGGWGGGGWWWWGW
GGMGMMGGWWGWWGWGWWGWGGGGMGWWGGGWGGMMGWWGWGWGGGWWWGGGGWGGW
GGMMGGWGGWWWGWGWWWWWGGMGGWGWGWWWGMMMMGGGWGGGWGGWGWWWWGWWW
GMGGWWWWWWWGWWGGGWGGGGMGGWWWWGGGMMMMMGGWGGMMGMMGGGWGGWGWW
MMMGWGWWWGWWWGMGGWGGMMMMGWWGWGMGMMGGGGWGGGMGGMMMMGWGGWWGW
GGGWWGGGGWWGWGGWWGGMGGMGWGGWGMGGGGGWGGWWWGMMGMGMMMGMMGGGW
GWWWGWGGWWWGWGWWWGWGGGGWWWWWGGMGGGGWWGGWGGMGMMGMMGGGGGGGG
WGWWGGGGWWGGWWWGGMGWWWGWWGGWWGMGGWGGWWWWGMGWGGGMMGMMMMMGG
WWWGMMMGWGGGGWGGGGGGWWWGWWWWGGGWWWWWWWGWGGWGGWWGMMMMGMGGM
WGGGMGGGGGGWWGWGGWWGGGWWGWWGWWWWGGGWGGWWGGGMMGGGMMGMMMMMM
WGGGMMMMMGGWWGGGGWWGWWGWWGWGGGGGWGWWGGGGMMGMMMGWGGGGMMMGG
GGWGGGMMMMGGGWWGGGGGWGWWGMGMMGMGGMGWWWGGGGGGMGWWGWGGGGMGW
WWGGGGGGMGMGWWWGWWGGGWWGGMGGGGMMGGMGGWWWGGMGGWWGWWGGMMGWW
GWWGWWGGGGMGWWGGGGGWWGWWGGGWWGGGMMGMGWGWWWGGGWGWGGMMGMGGW
GGWGWWGGGMGGGWWWWWGGWWWGGWGGGWGMGMMGWWGGGGGGWWWWGMMGMMMGG
WGGWGWWGGMGGMGWWWWWGWGGWGWGGGWGGMMGMGGMMMGMMGWWGGGGGGGGGG
GMMGGGWGGGWGGWWWGGWGGWWWGGGGWWWGGMMMGGGMMGMMMGGMGMMGMGMGG
GMGGGGWGGMGMMGGGGWWWWWGGWGWWWWGMMGGMMMMMMMMGMMGMMGGWGGGMM
