WWWWGMMGMMGWWGGWWGGWGWWGGGWGWGGGMGWWWGWWWWGGWWWWGWGMGGGMM
GGWGMGMMMMGWWGGGWGWGGWGWWWWWWWGMGWWGWWGWGGWWGWWGWWGGGWWGM
MGGGMGMGGGWGGWWWGGWGWWWWGGWWGGWGGGGMGWGWGWGGGGGWWGWGGWWGM
GMMMMMMMGWWGGGGWWGWWWGGGWWWWWGWWGMGMGGWGGWWGGWGGWWWWWWWGG
GGMMMGGMMGGGMMGWWWGGWWGGWWGWGGWWGGMMMGGGMGGMGGGGWGWWGGWWW
MMMGMGMMMGMGGMGGWWWWGGWWWGWWGMGGGMGGGGGWGMGMGWWWWGGWWGGGG
MGGGGMGGMMGGWGWGWWWWWGGWGWWGMMGGGMMGMGGWWGMGGWGWWWGWWWGWW
MGGGMMGMMMMGGGWWWGGWGMGWGGGGMMGGMMGWGGGGGWGGMGMGGGMGWWGWW
MMGMGMGGGGGMMGWWGWGWGMGGWGMGMGGGMGMGWWWWWGGMGMGMMMMMGWGGW
GMGGWGWGGWGGGWWWGWWWWGGWWWGMGMMGMMGGGWGWWWGGGGMMMGMMMGWGG
GMGMGGGMGWGGGWGWGGGGWGWWWWWGMMGMMGGWWWWWGGGGGMGGMMMGGMGGG
WGGGGGMMGGWWGWGGWWGWWWGWWGGGMMMMMMGGGGGGGMGMMMMGMMMMMMGGW
GGGWWGMGWWWWWWWWWWGWGGWGGMGMMMGGMMMMMMGGMMGMMMGWGGMGGGMMG
GGGGWWGGWGWWGWWGWGWWGWGMMGGMGMGMGGMMMGMGMMGMGGMGMGMMGMMGW
GMMGGWWGWGWGWGGWGGWWGWGGGGMMMGGGMGMMGGMGMMMMGMGWGWGGGMGWG
GMMMMGWWGWWWWWWGGWGWGGWWGMMGGGMGMMGGMMGMMMGGGMMGWWGWWGGGG
WGGGGWWGGGGWGWWWWWGWGGWWGMGGWGGMGMMGGMGGMMGWGGMGGWWWGMGWG
WGWWWWWWWGWWWGGWGGWGMMGGGMGGWGMMGGGMMGMGGMMGGGGWWWWWWGGGM
WGGWGWGGWGWWGWWGWWGGMMGMGMGGGMMGMGMMGGMGMMGMMGGWGWWGWGGGM
WGWWWGWGGGWWWGGGGWGMGMMMGMMMGGMGMMMGGWGMMGGMMMGWWGWGGGWGG
WWWGWGWWWWWGGGMGGGMMMMGMGMMGGMMMGMMGMGMMMMMMMGGWGGGGGGWGW
GGWWWGWGWGGGGWGMMMMMMMMMGGGGWGMMMMMGGMGMGMGMGMGGGMGGGWWGW
WWGWWGWWGGMMMGMMMGMMMGGMMGGWWGGGGGGGWGMGGGWGGGMMMMGWWWGWW
WWGWGMGGGMGMGGMMMGGMGMMMGGGGGGMMGWWWWGGGWWWGWWGMMGGWWGGGW
GGGWGGWGGGMMMMMGGGGMMMGMGMMMGGGMMGWGGGGWWGGWWGGGGGGGGGMGG
GWWWGWWWWGMMMMGGMMGGMGGMGMMGMGGMMGGGGWWGWWGGGGGGWGWWWGGGM
WWGGGWWWGMMGMGWGGGMGGMMMMGGGMMMMGWWWWWGMGGMGGGWWWWWWGMMMG
GWGMGGGGWGMMGWWGWGMMGMMMMGMMGMMMGGGWGGWGWGMGWWGGWWWWGMGGW
