GWWGWWWWGMMMMGMGWGMMMGMMMMMMMMGWWGMGGWWWGGMMGMGMGMGGGWWWW
GGGGGGGWGMMMMGMMGGMGMMGMMGGGMGWWWGMGGGGWGGGMMMGGGMGWGWGGG
WGGWWWWWGGMMMGGMGMMMMMGGGGMMMMGWGMMMGGWWGWWGGGMGWGGGWWWGG
WGWGGWWGGGMMMGWGMMMMMMGGWWGGMMGGGGMGGMGWWWGWGMGGGWWWWGWWW
WGWWGWGGMGGMGWWWGGMGGMGGGGWGGMGMGGGMMMGWWWGWWGWWWWWWGGWGW
GGGWWWWWGWGGWGWWGGGGMMMGWWWGGGMMGGGGGGMGGWWWWWGWWGGGWWGWW
WWWWWGWGWWGWWWGGGMGMMMMGGWWWWGMGGMGGMGGWWGGWGWWWWWWGGGGGW
WGGWGGWGGWWGWWGMGMMMGMGWWWGGGGGWGGGGMGMGGGWWWWGGGGGGGGWGG
GGGGMGGWWGWGWGWGWGGMMGMGGGGWGGMGWWGWGWGMGGWGWWGWWGGWGWGWW
MMGMMGGWGWWWWGWWWWGGMGGWGWWWWWGMGWGGWWGGGWWWWGGWWGGWGGWGG
MMGMGWGGWWWWWGGWWWGMMGMGWGWGGGMMGWWGGWGWWWGGGWGGWGWWWGGMM
GMMGWWWWGGGWGWWWGWWGMMMGGGWGWWGMGWWWWWWWWGWWGGGGWGWGGMMMG
WGMMGGWWWWGGGWWGWWWGMMMGWGWWGWGGWWWWWGWWWGWWGGGGWWGGGMGMM
GGMGMGWWGGWWWWGGWWWGGMGGWWWWGGWWWGWWGMGWWWWGMMGWGGWGGMGMM
GGGGGMGWGWWGGGWGGGWGMGWWWWGWGMGWGWWGMGWGWGGGGMGWGGWGGGWGM
MGMGMMMGGGWWWWGGMGGGMGWGGWGWGMGWWWWGGMGGGMGMMGGWWWGGGWGGM
MMMGMMGWGGWGGGGMMGWGMGWWGGGWGGWGGGWWGMGMMMMMGGGGWWWWGWWGG
GGMMGGWWGGWWGWWGGGWWGWGWWWWGGGWWGWWWGGMMMMGMGMGGWGGWWWGMG
MMMMMGGWGWGWGGGMMMGGGWWGWGGWWGGWWWWWGMGMMGMMMMGWGGGWWWGMM
MGMGGGWWGWGWGMMGMGGGWGGGWWGGWGGGGWGWWGGGGGGGGGGGGWGGGGGMM
GWGWWGGWWWWWWGGMGMMMGGWGGGWWGMMGMGGWGWGWGWWGWWGMGGGWWGWGM
WWWWWWWGWGGGWGGMGGMMGMGWGGWWWGGGMGWWGGWWWWWGWGGMGWWGWGWWG
WWGGWGWGWWGWWGGMGGGGGGGWWWWWWGWGMMGGGGGGWGGGGWGMGWWGGGWWW
GGGWGWWGGWWGWGGGWGMMMMMGGGWGGGWGMGWWWGWGWGGWWWGGWGWWGGWWW
GWWWGWGWGGGWWWWGGMMMMMGGGWWGGWWWGGGWWGGGWWGWGWGWGGWWWGGWW
GWWGGWGWGWWGGWGMMGMGMGGGWWWGWWGGMGGGGGWWGGGGWWWWWWGGGGWWW
GWGMMGMGGWWGGWGGGMGMMMGMGWWWWWGGGWGMMGGWGWWWWGGWGWWGGMGWW
WWGGMMMGGWWWWWWWGGMGMMGGGGWWWWGGGWGMMGGGWGGGGGWWWGGMMMGWW
