WWGWWWGGWGWWWGWWGMMGWGGMMGGWWGMMGGGGWWGGGGWWGMMGMMGMMMMGW
GWWGWWWGGWWWWGWGWGGWWGGMMMGWWGMGGGMGWWWWWWWWGMMMMMMGGMGGG
WWWWGWWWWWGWWWWGWWWGWGMMGMMGGMMMGMGWWWGWWWGGWGGGMMGMMMMMM
GGWGGWWWGGGWWWWGWWGGWGMGGMGWGGMMGGGGGGGGWGWGGMGGMGGMMMGMM
GWGWWGGGWGGWGWWWWWGGGMGGMGGGMGGGMGGMMGWGWWWGGGGMMGMMMGMMG
WWGGWWGWWWWWGGGGGGMMMMGMGGMMMMGWGWGGGMGWWWGGMMMMGMMGGGMMM
WGWGWWWWWGWGWWGGMGMMMMMGGMGMGMGGGGMMMGWWGGWGGMMGMMGWWGMMG
GWGGWWWWGGWGWWWGMMMMMMMGMMGGMMMMGGGMGGWGWWWGMGGWGMGGGGMGM
WGGMGGGWWGWWWWWGMMGGGGMGGGMGMGMGGMGGWGWGWWWWGGWWWGGWWGMGM
GWGMGWWGWGGGWWGMGMMMGGMGMGMGGMGGGMGWWWWGGGWGWWGWGWWWGGGGM
GWGMMGGMGMGWWGWGMMMMMMGMMMMMMGMMMMMGGGGGWWWGGGWGWWWGMGMGM
GWGGMGMMMMGWWWGMMMGMGGGGGGGGGMMGMMMMGWGGWWGGMGWWWGWGGWGMG
MGGMMMGGGGGWGWWGMGGMMGGWWGGWWGGGMMGMGGWWGWGGGWWGGGWWWWGGG
MMGMMGGWWGGWGGWGGGWGGGMGWWWWGMGWGMMGGGGGWGGMMGGWGGGGGGGMG
MMMMGWGGGMGWGMGGWWGGMMMMGWWWGGWGMMMMMMMGGGWGGGMGMGMMGMMMM
GMGGGGGGGMGGMMGWGGMGMMGGGWWWGWWGMMMGMMGWWWWGMMGGGWGMGMGGM
WGWGWGMGGGWWGGMGGMGGMGWWGGWWWWGGGMMGMMGGGWGWGMGMGGWGGMMGG
GWWWWWGGWGGGWGMMMMGMGMGWGWGGGWGWGMGGGMGWWWWGGMGMGMGMMMGGW
WWWGGGWWWWWGWGMMMGGMMGMGGWGGGWGWGGMGWGWWGWWGWGGMMMGMGMMMG
WWWGMGGWWGGGWGMMGGGGGGMMGWWWWWWWGMGWGGWWGWWWWGGMMMMGWGGGG
WWGGGWWWGWGGWGGGWWWGWWGGMGWWWWWWGGWGGWGWWWWWGWWGMGMMGGGGG
WWWGWWGWWWWWGWGGWWWGGWGMMGGGWWGGWGGGMGGWGGGWGGGMMMMMGMMMM
GGWGGWGWGGGWGGGGWGGGWWWGGWWWWGGWGMGGMGGGWGGWGGGMMMGMMGGMG
GWWWWWGGWWGWGGWWWWWGGGGGWWGWGWWGWGGGMMMGWWGGWGMMMGGGMMMMG
WGWGGWWWGGWWGWWWWWWWWWWWWWGGGGWWGGWGMGMGGWWGGMMGMMMMGGMGM
GWWGGGGWWWWWWWGWWWWGWGWGWGMMGGWWWWGGGMGMGGGMMMMGMGMGMGGGM
GWGGMMGGWWGWGWGWGWGMGMGGWWGMMMGWWWGMMMMMMMGGGGMMGGGMMMMMM
GWGGMGMGWWGGGWWWWGWGMMMMGGMGGGWGGWGGGMMGMMMMGMMMGWWGGMGMG
