WGWGGMGWWGMGWGWGGWGGGWWGMMMGGMGGGMGGGMGMMMMMGMGMGMGGMGGMM
WGWGMMMGGGGWWWWGWGMMMGGMMMMMMMGGWGGGMGMGGGMMGGMMGMGGMMGMM
WGWGMMMMGWWWWGWWWGMGGMMGGMMMMMGWWGMMGMGGGGMMGGMGMMGGGMMMM
WGWGMGGGWGWGGGWWWGMMMMMMMMMGMMGGWGMGGMGGGGMMMMGGGMMMMGGGG
GGGWGWGGWGWGGGGWWGGMGMMGMGMMMMGGGGGMGGGGWGGMMMGGMGMGMMMMM
WGWWWWWGGWGGGWGWWGMGMMGGGGGGGMMMGGMMGMMGGGGMGMMMMMMGMGGMG
WGWWGGWWWWWWGGWGGMMMMMMGGGGWGGGMMGMMMGGMMGGMGMGMMMMGMGGMG
WWGWGMGGWWGGGMGWGGGMMMGMMMGGMMGGMMGGGWGMGMMGMGGMMMGGMMMGM
GGGGMGGGGWWGMGWWGMMGMMGGGMGMMGMGMGGGGGMMMMGGGMMMMGMMMMGMG
GMMGMMGGWWGGGMGGGMMMMMGGGGWGMGMGMMGGMMMMGGGWGGMMGMGMGGMMM
GMGGMGMGGWGMMMMGGMGMGMGMMGWGMMMMGGGGGMMGMMMGMGMMGGWGWGMMM
GGGGGGMMMGGMMMMMMMGGWGGMGWGGMMGMMMMGGGGGMMMMMMGGWGWGWGMGM
WGMMGMGMMGGMGGMMGGMMGGMGWGWWGMMMMMGMGMGMMMGGMMMMGMGGWWGWG
GGMGWGGGMMGMGMMMMGMMMMGWWWWGMGMGMGMMGMGMGMGGMGMGMMMGGWWWW
GMMGGGGGMGGMMGMGMGMMMGGGGWWGGMMGGWGMGMMGMMMGGGMGGMMGMGWWG
MGMGGMMGMMMGMGMMMMMGMMGMGGWGGGMGMGMMMGGGMGMMMMGMMMMMGMGGM
GGMMGGMMMMGGMGGGMGGGGMGGGMGGGGGGGGGMMGMMMMMMMMMMMMMMGGWGM
GMMMGMGMMGWGMMGMGGGGGGGWGGWWGWWWWGMGMMMGMGGGMMMGMMGMGGGWG
MGMMGGMMGWWGGGGGGGWWWWWWWWGWWWGGWGGWGGGWGGMMMGGWGGMGMGWWG
MGMGGGMGWGGWGMGGGWWWGGGWWWGWWGWGWWGGMMGWWGGMGWGWGGMMGWGWG
GWGGGWGGWWGWGMMMGGWGWWWWWGWGWGGGWGMMGGMGWGWGWWGWGWGGWGWWW
WWWWWGGGWWGGMMGGGMGGGGGWWWWGGMGGWGMMMGGGGWWGWWGGGWWWWWGGG
WGGWWGWGGGWGGMMGGGGWGWWGGWGGMMMMGMGMGGWGGGGGWWGWWWGGWWGWG
WGWGWWWGWWWWWGMMGWWGGWGMGGMGMGMMMMGGWWWGWGGWWGWGWWGMGWGGG
WWWGGGWWWWGWGGMGWWGWWWWGWGGGGGGGMMGMGGWWGGWGWWGGWWGGGGMMM
GGGGGWGGWWWWGMGWWGGGGGGGWWGWWGMMMGGMMMGWWWGMGWWWGGGGWGMGM
GGGWGGWWGGWGWGGGWWWGGWWGWWGWGWGMGGGMGMGGGGMMMGGWGMGWGGMGG
MGMGWGWWWWWWWGWWWGGMGGWWWWGWWGMMMGGMGGMGWGMMGMMGMMMGGMMMG
