GWGWWWGGGGGWWGMMMGWWWGWGMGWWWGGMGMMMMGGMGGMGWWWGWWGWGWGGM
WWWWWGGWWWWWGMGMGGGGWWWGGGGGGGWGMMMGMGGMMMGGWGWGGWWWWGWWG
WWWWWGGGGGGWWGMMGWGWWWWWGWWGWWWWGMGMMMGMMGMGWGWGMGGWWWGWG
WGGWWWWWWGMGGMGGWGWGGGWWWGGGGWWWWGGGMGMGMMMMGWWGGWGGWGGWW
GGWWGGWWGGGGWGWGWGGGMMGWGGWWGGWGGWWGMMMMGMGMMGWGWWGGWGWWW
GGWGMGGGMGGMGGGGWWWGGGMGGGGWGWWWGGWWGMGMMMGGGMGGWGWWWGWGW
GWGMMGGGMGWGMMGGGGGWWGGGGWWWGWGWWGWGGMMGMMGWGGWWGWGWWWWGW
WWWGGGMMGGGWGMGGWWGWGWWWWWGGWWWWWWGGMGGGMGGWWGGWGGMGGGGWW
GGWGGGGMMMGWGMMGWWWGGWGGWWWGGGWGWGGGMGMMMMMGGGGGGMGGMGWWG
GWWGMMGGGGWGWGMGWWWGGWWGGGGGGMGWGGMMGGGMGGGGMGMGGGGGGMGWW
WGGMMGWGGGGWWGGGWWWGWWWWGGGMGMMGMGMMMMMGGGGGMMGGGWWWGGWGW
WGGMMMGMGWGGGGMMGGWGGGGWGMMMMGMGMMMMMGGGMMMMMMMGWGGWWWGGW
WWWGGMMMGWWGGMMGGWGWGGGGGMGMMMMGGGMGGGMMMGMGGMGWWGGWGGGGG
GGWGGMGGGWWGWGMMGWWWGMGMMMGGMMMGWGMGMGMMGWGWGMGGGMGWGGMGW
GGGGWGMGGGGGGGGMGGWGWGMMMGMGGMMMGWGMGWGGGWGGGMGMGGGWWWGMG
MGGGWWGGWWWWGWGMGMGGGGGGGWGWWGGMMGGGMGWGGGGWGGGMGGMGWWGMG
MGGGWWWWGGWWWGWGGMMMGWGGGWWGGWWGGMMMGWWGGGWGWWWGWWGWWGGGW
MMGGGWWWWWWGGGWGMMMMGGWWWWGMGGGGGGMMGGWGGWGGWWWWWGGWWWWWG
MMGGGGWWGWGGWGWGGGGGMMGWWWGMGGMMMMGMGMGGGWWWWGWGWGGGGWGWW
GMGGWWWGWGGGWGWWGWWGGGWWGWWGMGGGMGMGMGWGWGGGGGWGGWWGWWGWW
MGGGWGGGGWGWWWWGGWGWGWGGWWGGMGMGGGGGMMGMGMGMGWWGWWWWGWWWG
GMGMGWGWWGWGWWGGWWWGWGGMGGGGGGMGGMMMMMMGMMGGGWWGGGWWWWGWG
GMMMGWGWWWWWWGGWWWGGGMMMGWWWGMGWGGMMMGMMGMGWWWWWWGGWWWWWG
WGMMGGGWWWWGWWWGWWWGWGGMGWWWGGWWGMGGGWGGMMGWGGGGGGWWGWGWW
GWGMGGWWGWWGGGGMGGGMGMMGWWGWWWWGGGGWWGGGGMGWWGGGMGWGGWWGG
GWWGWWWWWGGWWGMMMGMGMGGWGGGWWGWWWWGWWWWWGMGGWWWGGGGWWGGGG
WWWGWWWWGGGWGGGGGWGMMMGWWWWWGWGGWWWWWGWWWGGGWGGMGWWGGMGGW
GWWGWWGGGGWWWWGGWWWGGGWGGWWGGGGGWGWGGGGGGWWGGGMGWWGMMGGMG
