MMGMGGWGGGMGGWGWWGGGMGMGGMMGGMMGGWWGGWWGGGGGWGGWWGGMMMMGM
GGGGGGGMMGGMMGMGGGWWGGMGMMGWWGGWWGWWGWWGGWGWWWWWGGMMMGMMG
WWGGGGGGGGMMMGMMGGGGGMMMMGWWGGGWWWGWGWGGWGGGWWWWWGMMGGGMM
GWWWGGWWGGGGGMMMMGMMGMMMMGWWWWWGWWWWGGGGWWWGWWGGWGGGGMMGM
WGWGWWWGGGWWGMGMGGMGMGGGGMGGGGGGWWGGGWWGWWWGGGMMGGMMMMMMG
WWGWWWGGWGGGMMMGMMMMGGWGGMMGGMGGWWGGGGWWWGWWWWGGGMGGMMGMM
WWGGGGWWGGGMGGMMGMMGGMGMGMMMGGMGGGGGWWWWWWWGWWGGMMMGGGGMM
WWWWWGWGMMMMGMMMMGMMMMMMMMMMMGMGGWWGWWGGGWWWWWGGMGGGWWWGG
GGWGWGWGMGMMMMGGGMMMGMMGGGMMMMMGWWGWGGGGGGWGGWGMMMGWWWWGG
MGWGWGGGMMMGGGGMMMMMGMMGGMGMGGGGWWWGGWGWWWGWGWGMGGGWGGGWW
GMGWGGMMMGMGGGMMGMMMGGMMGMMGWWWWWGWWWWWWWWWWWGMGGMGGGMMGW
WGGWGWGMMMGWGGMMMMGMMMMMGGMMGGWGWWWWGWGWWWWGGWGGGMGMGMGMG
WWGWWGGMMGWGGGGMMMGGGMMMGMMGMGWWGGGGGGGGGGGGWWGMGMGMMMMMG
GGWGGGMGGGGMMMGMGGGMMGMMGGMMGWGWWWGGWGGMGMMMGGGGGMMMGGMGG
GMGGGWGWWGGMGGMGGGMMGGGGGGGMMGWWGGGGWWGMGGMMGMMMMMMMMGGWG
WGMGGWGWGMMMMGMMGWGMGWWWWGMGGGGGGWGWGGGGMMMMMGGMMMGMMMMGM
WGGWWWWGWGGGGMMMMGMMMGGWWGMGWWWWGWGGGGMGGGMGMGGMMGGMGMMMM
WWGWGGGGWGGWGGGGGGGGMGGWGGMMGGGWGGGGWGMGMMMMGMGGMGWGGMMMG
WWWWWWGGWWGGGMGGGMGWGGWGWWGGGGWGWWGGGMMMGMGGGMGWGGGGGGMGG
GGWGWGGGGWWWWGWGMGWWWWGGGGWWWWGGGGWGGGGMGMMGGMMGGGGGMGGGM
GWWWGWWGMGWGWGGGGGGGGGGWGGGGWGGWWWGMGGMMMMMGGMMMMGGMMMMGM
WWGWGWWWGWWGWGWWWWGGMGMGGMGGWWWGWWGGWGGMGGGMMMGGGMMGMMGWG
WWGGMGGWGGWGGGGGWGMMMMMGGGWWWGGWGWGGWWGMMMMMMGGGMMMMMGGGM
WWWGMMGGMGGWGWGGGMGGMMMMGGWWWWWGGWGGGWGMMGGMMGGMMMGMMMMMM
WWGMGMMMMGWWWWGGGGMMMMMGMMGGWWWGWWWGGGMMMMMMGGGMGGGGMMMGG
WGGGMMGMGWGGGGWWWGMMGMGGGMGGWGWGGGGGMMMMMMGGWGGGWGMMGMMMG
GMMMMMMGMGGGWWWWGWGGGMMGWGGMGWGWGGMMMMGMGGGMGGMMGGGGMMGMM
MMMMGGGGMMMGGGWWWWWGGGGGGGMGWWWWGGGGMGMGWGMMGMGMMMMMGMGMM
