GWGWWGGWWGGGGMGMGGMMGMGGGWGWWWWWWGGWGWWWGMGGWWGGGWWGWGGGM
WWWGWGGGWWGWWGGMGMGMGGMMGWWWWWGGGGWWWWGGGMMMGWGMMGWWWGMGG
GWWWGMMGGWGWWWGGMMMGMGGGGWGWGGGGGWWWGGWGMGMGWGGGGGGGGWGGM
GWWWGMGMGGWGGGGGGGGMMGMMGGWGWGGGWGGWGMGGGGGGGGWWWGMMMGGWG
WWWGMGWGWWGMMGWGMMMMGMGGGWWWGWWGGWWGMMGGGMGMGGWGGGMGGGMGW
GWWWGWGWWGMGMGGMMGGGMMGWWWGWGWGGGWGWGMMGMMGMMMGMGGGGGGGWW
WGGWGWWWWGGMMGGGGWWWGMGWGWGGGGGGWWWWWGMMMGGMMGMMGGWWGWWGG
GGMGGGWWGMMMGWGWGGWGWGMGGWWGMGWGWWGWGMMGMMGMGWGGGGWWWWGWG
GGMGWGWWWGMGWWGGWGGGWGGWGWGGGMGWWGWWGMGMGMGMGWGWWWWWGWGWW
MMMMGGWGGMGWWWGGWWWWWGGWGWWGWGGWGMGWWGGGMMGGGWWGWWGGWWGWG
GGGGWWWWWGGGWWWGWWWGWWWWWWGMGMGGWGWWWWWWGGMGGGWGWGWWGWWWW
GGGWWGWWWGGGWGGGGWWGWWGWWWGGMMMMGGWGGWGWGWGGWWWWGWWGWWWWG
GGWWWGWWGGWWWGGWGGGWWWWWGGMMGGGGGWGMMGGWGWGMGWGWGWGWGGWWW
MGGWGMGGWGGGGGGWWWWGWWGGMGGGGWWWGGMMMGGWGWGGGWGWGGMGMMGWG
GWWGMMMGWWGGWWWGGWGMGWGGGGWWGWGWGGMGMGGWWGGGGWGGGWGMMMMGM
WWGGGMGMGGGWWGWWWWWGGWGMGWWWWGWWGMGMMGWGWGMGWGMGGWGMGMGMG
GWWWGMMMGGGWWWWWGGWWWWGMGGWGGGGGWGMMMGGWGWGWWGGWWWWGGGMGG
WWWWWGMGGWGWWWGWWWWGGGWGMMGWGGMGGMMGGGWWWGGWGWWWGGGWWGGMG
WWWGWGGGMGGGGGGWWWGMMGWGGGGWWGGGWGMGGWGWWWGWGGGWWWGGGWGGW
WWGGGGMMMGGMMGMGGGGMMGWGMGMGWWWGGGGMGGWGWGMGWWWWWGWWGGGGG
GWWWGMMGMGGGMMGMMGGGMGGGGGMGWWWWGMGGGWWGWGGGWWWWWGGWWWWGG
MGGWWGGMGWWGMMMGMGWGGWWGWGGWGWWWGMGWWGWWWGWGWGGWWWWWWGWGG
GGGGWGMGGWGWGMMGMGGWWGGMGGWWGWWWWGWGWGWGWGWWWGGWWGWGGWGWG
GWGWGMMGMGGWGMGGGMGGGGGGGWWWWGGWGWWWWWGGGWGGGWWWWWWWWGWGG
MGGGWGMGGWWWWGGMMMGMGGGWWGGWWGGGWWWWGWGGGWWWGWWGGWGWGWGWW
GWWWGGMGWWGWWWGMGMMMMMGGGWWWGGWWGGWWWWWWWWGWGWWGWWWWWGGGG
WGGWWGMGGWGWGGGGGMMMMGMGGWWWGGWWGWWGGGGWGGGWGGWGWWGGWWWGM
GWWWGGMMMGGWGGWWGGMMMGMGMGWGWWWGWWGMMMMGMMGGWWGWGGWWGGGGM
