GMMMMGGGWWWWGMMGWWWGWWGGWWWWGGWWGMGGWGGWGMMMGMMGGGWGWGWGW
MGMMMGGWWGGGMGGWGGGGGGWWGWWWGGGGWGGGGGMGMMMMMMGWGWWGGGGWW
GWGGGWWWWGWGGWWGMGWWWWWWGWWWWWGMGMGWGWGGGMMMGGGWGWWWGMMGG
WWWGGGWWWWWGGGGGMGGWGWWGGGGWWGMGMGWGGWWGGGGMGGGGWGGWGMGMG
WGWWWWWGGWGWGGWGGGWGWGWGWGGGWWGWGGWGWWWWGWGGMGGGGGGGWGGMM
WWWWGWWGGWWWGGWWGGWWWWWWWGWWGWWWGGGGWWGGMGWGGWWGGGMMGMMGG
WWWGGWWWGGGWWGWWWWWWGGGWWWWWWWWWWWGWWWWGGWGWWGGMGMMMMMMGG
GWGGGGWGGMMGWWWWGWGGGGGWWWGWWGWWGGWWGGGWWWWGGWGMMGGMMMMMG
WWWWWWWWWGGGWGGGWGWWWWWWWGWWGGWGGMGWWGGGGWWGWWWGGGWGGMMGG
GWGGWWGGGMGWWWGGWWGWWWWGWWWGWWWGGGWWWWWGWGWWWGWWWGGGGMGMM
GGMGWWWWGMGGWWGWWWWWGWWWGWGWWGWGGWWGWGGWWGGGGGGWWGMMMMMMM
MMGGWWWWWGWGGWWGGGWWWGGWGWGWGWGMGGGGGWWWWWGMGGWWWGMMMMGGG
MGWGWGGGWWWWGGGWGGGWWWWWGGWWWGGMGWGWWWWGGGGMGWGGGGMMMGGMM
GWWGWGWWWWGGMMGGMGWGGWWWGWWGWWGMGWWWGGWWWWWGGWWWWGMGGMMGM
GGWGGGWGWGMMMMGMMGGWWWWWWGGWGGWGGWGGGWWGGWGGGWGGWWGGMMGMM
MGGWGWWWWWGGGMMMGGGGGGGWWWGWWGGWWWGGWWGGWWGWGWWGWGGMGGGGG
GMMGWGGGGWGMGMMMMMMMGWWWWWGGWGMGWWGGGWGWGWGWWWGWGGMGWWWWG
MGMMGGWGGGMMMGGGMMMGWGGWWWWWWWGWGGWGWWWWWWWWWWGGMMMGGGWWG
GGMMGMGWWGGMMMMMMGGGGGWWGWGWGWGWWGWWWWWWWWGGGGMGMMMMGWWWG
MGMGMMMGGMGMMGMGGWGWGWWWGWGGGGWGGGGGGGGGGGGMGGMMGGMGWWGWG
GWGWGGGMMGGMMMGGWWWWWWGWGWWWWWWWGWWGGGMGWWGMMGGGGGGWGWGGM
WGWGGWGGMGGMMMGWGGGWWGWGWWWGGGWWWWGGGMMMGWWGGGGGWGWWWGGWG
GMGGGGGGMMMGMMGGWGWGWWWGWGWGGGGGWGGMMMGGWWGWWGWWWGGGGWWGM
WGWWWWGGMGMGMMMGWWWWWGWGGGGGMGWWWWGGMGWWWWWGWGGGWGMMMGGGG
WGWGGWGGGMMGMMMGGWWWGMGMGWWWGWGGWWGWGGGGWGWWWGGGGWGMMGGWG
WGGWWWWGGGMGMGMGGGWGWGWGGGWWGGGWGWWWWWWWWGWWGGWGGWGGMGGGM
GGWGWWWGGGMMMGMGGMGWWWGMMGGGWGWWGGGWGWWWWWGWWWWWGWGMMMGGG
MGGWWGGMMGMGGMMGGMGWWGMGMMMGWGGWWWWGWWGWGWGWGGGWWWGMGMGMG
