MMGGWGGGGMMGGMMGGWWGMGGGGWWWWWWWGWWGGWGWWWGMGGMMMGMMGGWGG
MGGMGGWGGMMMMMMMMGGMGWGWGGGGGWGWGGWWWGWGWGGMMGGMMMMGMMGGM
MGMMGGWGMMMGGGMMMMGMGWWWWWGGGGWWWWGWWGWGWWWGGGGMGGGMMGWGM
GGMMGGGMGMGGWGMGGMGGWWWGGWWWGGWWWGGWWGGGGGGGGWGGMGMMGWGGM
MMMMGMGMGGWWWGMGMMGGGGGWWWWGWWWWWGGWWGWGMMMGGGGGMGMMGWGGG
GGGMMGGGMMGGGGGWGGMMGMGWWGWGGGGWWWGGWWWGGMMMGGMMMMMGGGMMM
WGWGGWGGMMMMGGWGWWGGWGGWWWGWWWGWWWWGWWGMMMMGMMGGGMGMMGMGG
WWWWGWWGMMGGGMGWWGGGGWGGWWWWGWGGGGWGGWGGMMGMMGGMMMGGMMMGW
GGGWWGGMGMGGMGGWWWWGWWWWGWGWWGGMGGGGGWGGMGMGGMMMGMMMMMGGW
GGGGWGMGGMGMMGMGGWWWWGGWWWGWWGGMMGGWWGGWGMGWGGGGMGMMMGWWW
WGWWWGMMGGGMMMMMGGGWGWGGGWWGWGMGMMMGGGGWGGWWWGWGGMMGMGGWW
GWWWGMGGMMMMGMGMGMGGWGWGWGWWWGMGMMGGGGMGWGGWWGWGWGMMMGMGW
GWWWGMMGMGGGGMMMGMGWWGWWGGGGWWGMMMMGWGMGGGWWGMGWGGMGMMGGG
GWWGGMGGMGMGWGGGMMGGWWGWWWWGWGGMGGMGGGMGWWWGMMGWWWGWGMGGG
MGGMGMMMGMMGWGGMMGGMGGGGWGWGGMGGWWGWWWGGGWWGMGWWWGGGWGGMM
GMMMGGGGGMMGWWGGGGWGGMGWGMGWGGGGGGGWGWGWWWWGGGWWWGWGWWWGG
MMGGGGMMGMGWWWWGWWWGMGGGMGWWGGWGWWWGGWGGGWWWGWWWGGGGWWWWW
MGMGGGMGGGWGWGWWGGWGGGGMMMGWWWWGWWWGWWGGWGGWGWGGGGGMGWGGW
MGGGGMGWWGWGWWGWWWWGMGMMGGGWGGGMGGWWWGWWGMGWWWGGGWWGMGWGG
GMMGWGWWGGWGGWGWWWWGGMGGGMGGGMMGGWWWWGGWWGMGWWWWWGGGMMGMG
GGMGGWWGGGGGMGGGGWGGMMMMMGWGMGGWWWGGWWGGGGMMGWWGWWWGGGWGG
GMMMMGGGWWWGGWWWWGMMMMGMMGGMGMMGGWGGWGGWGGGGWWGGWWWWGWWWW
MMMMGGGGGGWGGWGWWGMMMGGGGMGMGGGWWWGMGGWWGWGGWGMGWWGWWWWGW
MMMMMGGGGWWGWWGGGGGMGWGGGMMMGMMGGGGGGMGGMGWWWGGWWWGGGWGWW
GMMMMGMMGWGGWGWWWWWGWGGMMGMMGGGMGWGGMMMGMMGGGWWWWGWWWWWWG
WGGMMMGMMGWWWWWGWGWWGGMGMMMGMMGGWWGGGGGMGGGGWWGGWWGWGWGWW
WWWGMMMMGMGGGGGGWWWGMMGMMGMMGGGWGWGMGMMMMMMMGGGWWGMGWWWWG
GGWGGGGMMMMMMGGWGGGMMGGGMMMMGMGWWGWGGMGMGGGMGWWWWWGWWWWGG
