GWWGGGGMGGMMGGGGGWWWGGGMGMGGGGWWWWGMGGMMMMGGGWWGWWGGMMGWG
WWGGWGMGWGGGWWGGWWWGGWGGWGGWWWWGGWGGWWGGGMGWGGGWWWWWGMMGM
GGWWWGGMGGMMGWGWGWWWWWWWWWWWGWGMGGMGGGMMMGGWWGGWGWWGMMGMM
GMGGWWWGGGMGGWWGGWGGGWGWWWGGGWGMGGGGGGMMMGWWGGGWGGWGMMGGG
GGGGWGWWGMMGMGGMGGWWWWGGWWWWWGWGMMMGGMMMGGWWGWGWWGGMMMMGM
WWWWWGGWWGMGMMGGGGWWGGGWWGGWGGWWGMMMGGMMGWWGWWWGGGGMMGMGM
GWGWGGGWWWGMGMMMMGGWGGGWGGWWGWGGWGMMGGGGWWGWWGWGMMMMMGMMG
MGMGGWWWWGMMMMMGMGWGGWGWWGWWWGWGWGGMMMGGWGGWGWGGGGMGGWGGW
MMMMGWWWGGGMGGMGGWGWWWWGGGGWWWGGWGMMGGGGWGGWWWWWWGGMGGMGW
GGGMMGGWWWGMGGGMGWGWWGGGGGGGGWGWGMGGGWWWWWGWWGWGGGWGMMGWW
MMGMGWWGGGGMMMMMMGWWGMGGWWWWWWGGMGGWWWWWGGGWWWWWWWGGGMGGG
GGMMGGWGMMGMGMGGMGWGGMMMGGGWGGGGMGWWWGWWWGGWGWWGGWGMGMMMG
WWGMGGWGMMMGMGMGGGWWGGMGGGMGGGMMGGWGWWGGGGWWGWGMMGWGGMGMM
WGGMGGGGMMGGGWGWWWWGGMGWGMGWGWGGMMGWWGMMGGWGWWWGMMGGMMGMG
WGGMMMGGMGGMGWWWGWGWGGGGMMGWWWGGGGGGGGGMGGGWWWGGMMGMMMMGW
GGGGGGGGMGMGGGWGMGGGMMMMMGGWGWWGWGMMGMGMMMGGGGGMMGMGGMMMG
GWGWGGWGMGGMGGWGMMMGMGGMMMMGGGWGGMGMGGMMMMGMGMMMGGMMGMMMM
WGWWGGGMMGMMGWWGMGGMMGMMMGGMGGWGMMGMMMMGMMMMMGMMMGMGMGGMM
GGGWGGWGMMMMGGGGGGGMMMMGMGGMMMGGMGMMGGGMMGMMMMMGGMGGMMGMM
WGGWWWGGMGMMGGWGMGGMMMGMMGMGGGMGGWGGGGMGGMMMMMGGMMMGMMMMG
WWWWGGMMMMMGWWGMGGWGMMMGMMGMGGGGWGMGMGMMGGMGGGMGGMGWGGMGM
GWWGWGMMGMMGWGGGGWGGMGGWGMGGGMGGGGMMMMMMGGGMGGMMMGMGGGMMM
WGGGWGGMMMGGWWWGWWWGMGGGWGWGGMGGGGMGMMMGWWWGWGGMMGMMMMMGG
GGGGWGMMMMGGGWGGWGWWGWGWWWGMMMGMMGMMMMGMGWWGGGMGMMMMMGMMG
WWWWGWGGGGGMGGGGWGWGGGWWGGWGMMMMMGGGMMMGGWWWGMMMGMGMMGGMM
GWGWWWWWGGWGWWWGWGGGWWGGMGGGMMGGMMMGGGMMGGGGGMMGMMGMGMMGG
WWGWWWWWWWWWWWGMGWWWWWGGMMGWGGMMGMMGGGMGMMMGGGMMGMMMMMMMG
WGWWGWWWGGWWWWGGGGGWWGMMGMGGMMMGGMMGGMMMMGMMMMMGMGGGGMGGW
