WGMMGGMGWWWGGGMMMGGWWWWGWGWWGGMMMMMMGGMMGMMMGWGGWWWWWWGWW
GGGMMMGWGWGMMMGMMMMGWGWWWWWWGWGMMMGMGMGMMMMGGGWWGGWGGWGWG
GMMMMMMGMGMMMMGGMMGGWGGWGGWGGWWGGGMMGGMMMGMGWGWWGGWWWWWWW
MMGGGMGGMMGMGMMGGGGWWWWGMGWGWGGGGMGGGMMMGMMGWWWGWGWGWGGGG
MMGGMMMMMGGMGGGGMGGWGGGGGGGGGMMMGMGMGMGGGMMMGGGMGGWGGMMGW
MMMGMGGMGGGMGGGGMMGGGWWGGWGWWGMGGMMMMMMGGMGMMMMMGGGWGGGWW
GGGGMMGMGGMGMGGMMGGMMGWGGWWGGMMMMMMMGMMGMMGMMMMMGWGGWGGWW
GMMGMMMMMMGGMMMMGGMMMGGGGWWGMGGGMGGGGMGMGMMGGGGGWWGGWWGWG
MGMGMMGGMMGGMMGMMMMGGWGGGGWGMGMMGGMGMMGGGGGGGMGGWGGGWWWWW
GGMMGGMMMMMMMMGMGMMGGGWWWWGGMGGMGGMGMGGGMMMGWGGWWWGGGWWGG
GGGMMMGGGGGGMMMMGMMGMGWGWGMMGGGMGGMMGGMMMGMMGGWGGWWGGGGGG
WWGMGGGGWGGGMMGGGGMMGWGMGGGGGGGGMMGMMGGMGMMGGMGGMGGGWWGWW
WGGMMGWWGMMMMMMGWGMGWGMGMMGGGGMMMGGMMGMMGMGWGGMMMGGWWGGWG
GWGMMGWGGMGGGMGWWGGGWWGMMGGWWWGMMGMMMMGGMMGGGGGMGMMGGGGGW
GGMMGGWWGMMMMGGWGGWWWGWGGWWWWGMGGMMMGGGGMGMGGGGMGMMMGGWWW
MGGMMGGGMMMGGWWWGMGWGGWGGWWWWGGMGGMMGMMMGMMGGMMGMMGMGWWWW
MMGMMMGGGGMMGGGWWGMGMMGGGGGGGMMMMGGMGMMMMMMMMMGGGGGGGWGWG
GMGMGGWWGMMMMGGWGMMGGGGMGWWGGMMGGGWGGGMGGMGMGMGMGMGMGWGWG
MMMGGGWWWGMGMGGWGMMMGWGGWGWGGMMMGWWGWGMGMGMMGMMMGGMGWWGGM
MMMGGGWGGGMGMGWWWGGMGWWGWWWGMGGGGGGGGGGGMMMMMGGMMMMGWWGGM
GMGWWWGGWWGMGGGWGGMGMGGWWWWGGWWWWWGGGWWWGMGMGMMGMGGWWWWGM
GGMGGWGWGWGMGWWWWWGGGWWWWGWGGGGGWGGMGWGWGGGMMGGGGGGGWWWWG
GGGGWWWGGWWGWWWWWGMMGGGWWWGWGWGWWWWGGWGWWGGMGMGWWWGGWGGWG
WGGWGGWWWGWWWWWGWGGMGWGWWWWWWWGGWWWWWWWWGGWGMMGWGWWGWWWWW
GWGWGMGWGGWGWWWGWGMMGGGWWGWWGWGGGGGWGGGGGGGWGGGGGWGWWGGGW
WGGGWGGGMGWWWWGGWGMMGMGWWGWGGGMMGMGGGGGWWWWWWWWWGGGGGGGWW
WGGWWGWGGMGWGWWWWWGGMMMGGGGMMGMMMMGMGWWGWGWGGGWWGGWWWGWWW
WWWWGWGGMMGWWGWGGGWWGGGWGMGMMMGGGMMMMGWGGGWWGMGWWWGGWGGGG
