GGGGGGMGWGMMGGWGMMMMGGGMMMMGMMMGMGMGGGMMMGGGGWGMMMGGWGGGW
WWGMGMGMGMGMMMGMMMGGGMGMMGMGMGMMMGGMMMMMGWWGGGMGMMGMGWGMG
WWGMGGMMMGMGMGMMMMGMMGMMGMMMGGGMMGMMGGMGMGWGWGGGMMGGMGGGM
GWGMGGGMGWGWGWGGMGMMMGMGMGMMGGMGMGGGGGGWGGWWGMMGGGMMGGMMG
WWWGGGGMGWWGWWGGGGMMGMMMMMMGGGMGMMGGGMGGGWGGMMGMMMMGMMMMM
WGGGGGWGWWGWGGGMMGGMMGGMMMMGMMMGMGGMGGGMMGWWGGGGGMMGGGGGM
GMGGWGWWGWWWWWGGMMGMMMGGMMMMGMGMMMGMGMMGGWWGMMGGMMGMGWWGM
GMMGWWGWGGWWGGGMMMGGMGGMGMGGGMGGGMGGMMGGGGGGMGMMMMMMGWGGG
GMGGGWGGMGGGGGGMMMGWGMGGMGGMGMMMMGMMMGGMMMGGMMMMGMGGGWWGW
GGMMGGGGMGGGGWGGMGWWWGMMGMGGGGMMMMMMMMMMGMMGMGMGGMMGGGWGW
WGMGWWWWGGWWGGGGMGWGGMGMMMMMMGMMMGMGGMGMGGGMMMGGMMGGWWWWW
WGMGGWGWGWGGGMGGMGWWGGMGMMGGGGMGGGGGGGGGMGMGMGMGGGGGGWGGW
GMMMMGGWWWGMGGMMMGWGGWGMGMMGMMMGGMMGMMGMMGMMMMMGMMMMMGMGW
MMMMMMMGGWGMMMMMGWWWWWWGMGGGGGGMMMMMGGGGMGMMMGGGGMMGMMGGG
MGMMMGGGMGMGGGGMMGGWWGGMGMGMGMMGMMGGGMMMMGGGMMMMGGGMMGWGW
MMGGMGMGMGMMMGWGGMGWWWGGWGMMGGGMGMGWWGMGMMGMGGGGMGGMGGWGG
MMMGGMMMMMGMMMGMGGWWWWWWGMMMMMMMMGMGGWGGGGGMGGGMMGGMGGWWG
GMGGWGGMMGMMGGGGWGWGWGWGGMGGMMGMGGMGGGMGWWWGMMMMGMGMGGWGW
MMMGGGMMMGMGWWGMGGWGWGWGGGMMMGMMGGMGMMMGWWWGGGGGGGGMMGWWG
GGMMMGMMGGMGGGMMGGGWGMGGGMGMGMMMMMMMGMGMGGWGGGMMMGMMMGGWW
MMMGMGMMMGMGWGGGWGMGMMGMGGWGMGMMMGMGMMMMMGGGWWGGGMGGGWWGG
MGMGMMMGGMMGGWGMGGMGGMMMGWGMMMGGMMGMGMMMGGGGGGWGGMGGGGGGG
MGMMGGGMGMMMMGMGGWGGGGMMGWGMMMGGGMMMGMGMGMGGMMGGGMGGMMMMG
MMMGMGMGMGMMMMGMMGGWGGGMMGWGGMMMMGMMMMMMMMGGGGMMGMMMMGMMG
MGGGMGGGMGMGGMGGMGWWWWWGGGGGGGMMMGMGGGMMGMMGGMMGMGMMMGGMM
MGWGGGGMMMGGGMMGMMGWWWGMGMMGMMMMMMGGMMGMGMMMMGGMGGMMMMMMM
GGGWGMMMMMGGGGGWGGWWGWGGWGGGGMMGMMMGMMMGMGGMMMMGWWGMGGMMM
WGWGGGGGMGGGWGGWGWWGGWGMGGGGGMMGGGMGMMMGMMMMMMGWGGGMGMMMM
