GWWGWGGGMMGMGWGGGGWGGGWWGWWGMGWGGGGMGMMMMMGGMMMGGGWGMMMGW
GWWWWGMGGMGMGGWWWWGWGWWWGWWWGWGWGWWGGMMMMGGGMMGWWWGWGGGGW
WWWGGMMGGGGMGWWWGGGWWGGGGWWGGGWWWGWGWGGGMGMMMGWWWGGGWWGWW
WWWGGMMMMGWGMGWGGGWWWWGMGWWWWWGWWGWWWGMGGWGMGGGWWWWWWWGGG
GWGMGMGMGGGWGGGGWGGGGWWGWWWWWWGWWGGGWWGGWGWGWWGWWWGGWGWWG
GWGMGMMGWWWWWWGWWWWWGGGWWGWGWWGWGGGWWWWWWWWGWGGWGGWWGMGWG
WWWGMMGGWGGWWGWWGWGWGMGWGGGGWWGWWGWWGWGWGGWWWWGGGGWWWGWWG
WWWGMMGMGMGGWGGGGWWWGGGGMMMGWGWWGWGGGWGWGWWWGWGWWGGGWGWWW
WGGMMMMGMMGGWWWGMGWWGGGWGMMGWWWWGWWGGWGGWWGWWWGWGWWGGGGGW
GMGGMMMGGGMGGGGGMMGWWWWGMGGWWWGGGWGWWGWWGWWWWGGWWWWGGWWGG
GGGGGMMMMGMGMMGMGGWWGWWGGGGGGWWGGGWWGWGGWGWGWGGGGGWGWWGGW
MGMMMGGMGGGGMGMGWWGWWWGWGGGMMGGMMGWGGGGWGWGMGMMMGMGMGGGGG
MMMMMGGMMMGMMMGGGGGGGWWWGMMGGGGMGWGWGWGWGGGGWGGGMGMGMGGMM
MMMMMGGGMGWGMGGWWWGGWWWGGMMGGWWGGWWWWGMGGGGGWWGGGMMMMMMGG
MMGMMGGWGMGGGGGWWWWWWWWWGGMMMGWGWWWGGMGWWWWGWGWWGGMGGMMGW
GMGMGGWWWGWWWWGWGGWWGGWWWGGGMGGWWWGGMGWWGGWWGGWGGGGMMMGWW
WGWGGMGWGWWWGGGGWWGWWWGWGMGGMGGWWGGGGGGWGWGWGGWGMMMMMGGGG
WWWGMGGGWWWWWWWWGWGWGWWGGMMMGMMGGGGGWWWWWGGWGGGGGMGMMGGGG
GWGGGWWGWWWGWGWWWWGGWWGMMGMGMMMGGGWGGGWGWGMGGMMMMGMMGWWWW
WGGWWWWGGWGGGGWGWWWWWGMGMGMGGMMGMMGWGWWGWWGGGMGMGWGGGGGGG
WGWWGGWWWWWGGGGGWWWGGMMGGGMGMMMMGMGWGWWWWGMGMGMMGGGWGMGMM
WWWGWWGWGWGMMMMMGGGMMMGGGGMMGMGMGGGWWWWGGMMMMGMGMGMGGMGGG
GWWWGWWWGGMGGMGGWGWGMGGMMGGMMMGGGGWGWGWGMMMMMMMMGMGGGGWGG
GGWWGWWWGGGWWGWGGWWWGGMGGMMMGMMMGWWWGWGWGMGGGGMMGMGMGWWGM
GGGGMGWGMMMGWGWWWWGWGWGWWGGGWGGGWGGGGWGGWGMGWGMMMGGGGWGMG
GMMGGGWWGGGMGGWWWWWGWWWGWWGMGGWGWWWGWWWGGGGGWGGMGGGGGGMMM
WGGGGWWGGMMGWGWGWWWGGGGWWGGGWWWGWWWWWWWWGWWGGWWGGWWGWWGMG
GGWWGGWGGMGWWWGWGWGGWGWWGWGMGGWGGGWGWWWWWWWWGGWWWWWGWWGGG
