WGMGWWGMGGGWWGWGWGGMGWWWGGGWWWWWWGWGGWGWGMMGMGGWGWGMMMGGG
WWGGGWGMMGGWGGGWWGGMGWWGMMGWGGGWWGGGGWGWGGMGGGGGWWWGMGGWG
WWGWGWWGGWGWGWWGWWGGGWGGGGGGWGMGGGWWWWGGWWGGGGMGWWGGGWGGW
GGGGGWWWGWWWWWWGWWGMGWWWWGGWWWGMGGGGGGGWWWGGWGGWGWWGWWWGG
MMMGGGGWWWGGGGGWWWGGGWGWGWWGGWGMGWWGGWWWWGGWWGGWGGWWWWGGG
GMMGMGWWWWWGGWGWGWWGWGWGWWWGWWWGGWGGGWWWWWWWWGWWWGGGWWWWW
GGMMGWWWWWWWWGWWWWGGGWGGWWWWGWGWWWWGGWGGGGGWGWWWWGWGGWWWG
GGGMGGGGWGWWGMGGGWGMMGGGGWGGWWGWGWWGGWGGMGGWGGGGWGGWWGGWW
GWWGMGGWWWWGGGMMGWGGGGGGWGWWGGMGWWGMGWGMMMMGWWGGWGGGGGWWG
GGGGGGWWWGWWGMGGWWWWWGGWWWWWGGMMGWWGGWGMMMGWWGWWGWWGGGWWW
WGGWGMGWGGGGMMGGWGWWWGGGWGWWGGMGGGWGGWWGGMMGWWWGWWWGWWGGG
WGWGGGGGGGGMMGGGGGGWGGWWWGWWGWGWWGWGWWGMMMGGGGGWWGWGGGGMG
WGGGWGGWGGMGGWGWWWGWWGWWWGWWWGGWWGWWGWGMGGGWWWWGGWWGWWWGM
WWGGGWWWWWGGWGGWWGWWWGWGWGGGWGMGWWGWWGMMGWGGWWGGMGGWWWGGM
GWWGGGGGWWWGWGWGGGWGWWWGWWWGWWGGWWGGGMGGMGMGWGGGGGWGGWWGM
WWWWWWWGGWWGWWGGWWWWWGWWWGWWWWWWWGWWWGMMMMMGWWWGMMGMMGWGG
WWGGGGGWGGWGGGGWWGWGWGWWWWGGWGGGWWWGWWGMMGMGGGGGGMMMGMGGG
GWWGGGGGWWGWWGGGGGWWWWWGGWGWWWGGWWGGGWGGMMMMGWGMGMMGMGGMG
MGWWGMMGWGWWGWWGGGWWWGWWGWGWWWWGGGWGGWGMGMGGMGMMGGGMMMMGM
GGGGMMGGWWGWWWGGWWGGGWWGWWGGGGWGGWWGWWGGMMMMMGMGMGGMGGMGG
MMMMMGMGWGWWWWGWGWGWWGWGGGGGGWGGWWWWGGGGMGMGGMMMGGMMMMMGM
GGMMMGMGGGWGGWWWGWGGWWGGGGWGMGWWWGWGGWGWGGMGGMMGWWGGMGMGG
MGMMGMGGGWWWGGGWWWWGWWGGMGWGGGWGWGGMMGWWGMMGGGMMGGWWGGGMG
MMMMGGWGWWWGMGWWGGGGGGGGGGGGGGGGWGGGMMGWGGGMMGGMMGWGWWWGG
MGMGWWWWGWGWGGWWGGWWWGWWGGGWWWGMGWWGGMGGMMMGGWGGMGGGGWGGG
GGMMGWWWWWGWWWWWGWGGWGGWGGGGWWGGWGWWWGGGMGMMGGWWGGWWGWGGM
MGMGGWGWGWWWWWWWWWWWWGMGGWWWWGWWGGWWWGGGGWGMGMGWWWWGGGGMM
MMMMGWGGGWGWWGWGWWGGWWGWGWGGWGWGGWGWGMMGWGMGGGGWGWGGMGMMM
