MMMGGMMGGWWWWWGGMMGWWGGGGWWGGGWGGWWGMMMMMMGGMGGMMMMGGGWWW
MGGGMGMGMGWGWGMMMGWGGWWGGGWGWGWWGGGMMMGMMGWGMMMMMMMGGWGGG
MGMGMGMMMGWWWGGGMGWGWWGGMGWWWGWGGWGMGGMMGMGGMGMMMMMGGGGMG
GGGGMMGGGWWWWGMGGWGWGWGMGMGGGGWGGWGMMGMMMGMMMGGGGGMMMMGMM
GMMGGGGWWWGWGGGGGWWGWGWGMMGWGGGGWGGGGGMGGGGMGGGGGWGGGMMGM
GGGMMMGWGGWWWGMMGWGWGGWWGMGWWWGWGGMMMMMGWGWGGWWWWWWGGGMGM
MMMMMMMGGWWGGGGMMGWWWWWGGGGGGWWGMMMMGMGGWGWWWGWGGWGGGMGWG
GGGMGGGGGGGMGGGGGWGWWGWWWWWWWGGGMMGMMGWWWWGWWWGGWWGGGGGGW
GMGMGWGWWGMMGWWWWWGWGGWGGWWGWGWGMMMMGMGWWGWWGGMGGWGWWGWWW
MGMMGWGGGGMGGWGGGGGGWGWWGGGMGGWGMMMMMGWWWWWWGGGMGGGGWGGWW
GMMGGGGWWWGWGGWWWWWWGWWWGWWGGWWWGGMGGGGGGGWWGMGGGWWWGMGWW
WGGGMMGWWGGWWWWWGGGGWWWWWGWWGGWGGMMGWWGWWGGGWGMMGWWWGGWWG
WGMMMMGGWWWGGGWWWGGWWGGGWGWWWGGGGGGWWWWWGGGWGMMGWWGWWWWWW
GGGMGGWWWGGGWWWWWGGWGWGWWGWGWWWWWWGWWGWGWGWGGGMMGGGWGWGWW
GGMMGMGGGMGWGWWGWWGGGWWWGGWWWGWGGGGWGGGWWGGGWGGMMGWWWWGGW
MMMGMMMGGMGWGWGGWGMGWGWWGWGWWGWGGWWWWGWGGWWWWGWGGWGWWGMGW
GMGGMGGMMGWWGGGWWGGGGWWWGWWWGGWWWGGGWWGGWWGWWWWGWGWWWGGWW
WGGMMMMGGWWGGWWWGGMGGWGWWWWGWGWGWGGWWGWGWWGGWWGWGGWGGWWWG
WWWGMGMMGWGMMGWWGMMGGWGGWWGGWWGGWGGWWGGGWGWWGGGWGWWWGWGGG
WGGGMMGGGWWGGWWWGMGMGGGWGWGMGWGGWWGGGGWWWGWWWGGGMGWWGGGGG
GGMMMGWGGGGGGWWWWGGGGWWWGWGGWWGWGGGGGWWWGWWWGGWWGWWGGMMMM
MMGMMGWWWWWGWGGGGWGWWGWWWGMGWWGGGGGGWWWGWWGWGWWGWGWWWGGGM
MMGMGGWWWWWGWGWWWWWGGGWWGGGGGGMMGWGWWWWWGGWWWWWWWWWGWWWGM
MMMGGMGGGGWWWGGWGGGGGWWGGMGGGWGMMGGWWWGWGWWGWWGGGGWWGGWWG
MMMGMMGWWWWWWGGGMGGWGWWWGMGMMGGGMGGGWWWWWWWWGWGMGWWWGGGWG
GGGMMGGGGWGGGWGGMGWWWWWWGMGMGMGWGGWWWGGWWGGWWGMGWWGGWWWGG
MMGGMMMGGWGMGGMGGWWWWGWWGGGMMGMGGWGGGMGGGWWGWGMMGWGWWGGMM
MMGMGMMMMGMGMMMGGWWWWGWWGGGMMGMGWWGGWGWWWWWWWWGMGWGGWGGMG
