GWGWGWGWGGGWGWGGWGGGGMMGGMMGMMMMMGMGGGGGMMMMGMMMMGMMGMGMM
WWWWGWWWGGMGGWGWWWGMMGMGGMMMGGMGMGGGWGGMMMGMGMMMGWGGWGMGM
WGWWWWGWGWGGGWGGWGGMMGGMGGMMMMGMMMGGGMGMMGGMGGMGMGWGGMMGG
WWGWWWGWWWWWGGGMGMMMGGGGGGGGMMMMMGGMMMGMGGGMGGMGGWWGWGMGG
GWGWGWWGWWWGWGWGGMGMGGMMMGMMMGGGGWGGMGMMGMMMGMGMGWWGGGGWW
WGWWWWWGWWGWWGWWGGGMGMGMMMMMGMMMMGGMMGGGMGGGMMGMGWGGMGGWW
WWWWWWGWWGMGGGWGWGMMGGWGGGGMMGGGGMGGGWWWGGGMGGGGWGGGMGMGW
GWGWWGWGGGGGGGWWWGGGGGWWGWGGGWWWGGGMMGGGGWWGGWGWWWWGGMMGG
WWWGGWWWWGMMGGGGGWWWWWWGWWGWWGWGWWWGMGWGGWGGMGWGGGGMMGGGM
GWGWWWGGGMMGGMGMMGWWWWGGGGMGWWGWWWGGMMGMGGMGGGWGWWWGMMMMG
WGWGGGGMMGMMMGGMMMGWGWWGGMMMGWGGGWWGMMMGGMMGMGWWWGGMGMGGM
GWWGGWGMGMMMMMMMMMGGMGGMMMMMGWWGWWGMGGGMGMMGMGGWWGWGMMMMG
WGGWGWGGGGMMMGMGMGWWGGGGGGMGWGWGGGMMGMMGGGMMGGMGGWGMMMGMG
WWGWGGMMGMMGMGMMGMGGGMMMGMGGGGGGGMGGWGGWWWGGMMMGGWGGGMMMG
GGGGMGGMMGGMMGMGMGMMGGMGGGWGMMMMMMMGGMMGGWGMMMMMMGWWGMMMM
GMMGGGGMMMGMMMGMGMMGGMGGMGGGGMMGGMMGWGMMGGGMMMGGMGWGGGGMM
WGMGMGWGMMMGGMGGGMGWGGGMMGGMMMMMGMMGGGGMGWWGMGWWGGWWGMMGM
GMMMMMGGGGMMGMGMGMMGWGMGMGGMMGGMMGMGMMGGGGGGMMGGMGGGMGMMM
MGMGGMGGGMGGMMMGMMMMGWGMMGGGMGGGMMGGMMMGGWWGMGMGMMMGGMMGM
GGGWWGWWWGGGGMGMGMGGGWGMGWGGMGMMGMMGGGMGMGGGGMMMGMMGMMGGG
GWWGWWGGWGGMMGGGMGMGWWGGGWGGGMMMMMMGGGMGGGMMMGGGMGMMGMMMM
WWGWGWGWGWGMMMMGMGMGWWGGWGGWGMMGMGMGMMMGWGMMMMMGMMMMMGMGM
GGGWWGWGWWGGMGMGMMMMGGMMGGWWGMGMMGGMMGGWGGGMGMMMMMGMMMGGM
WWWWWGWGWGWGMGGGGMGMMMMGGGGWWGGGMGGMGMMGGMMMGMMMGGMMMGGWG
GWGGGWWGWWGGMGMMMMMMMMMMMMGWGMMMGMMGGGGMGGGGGGMGWGMGGMMGG
WGWWGWWGWGMGMMGGMMMMGGMMMMGGMMMGGGGWWGMGWWGWWGGGGWGWWGMGG
GMGWGGWGWWGGMGMGGMGGGMGMGMMMGGGWGGWGWWGWWWWWWGWGMGGGGGMMM
MGGWWWGMGWGMMGMMMMMGMMMMMMMGWGWGGWGGWWWGWGGWGMGMMMMMMMMMM
