GGGGWGMMGGGGGWGMGWGGWGWGGGGMGMGGMMGGGMGGGGMMGGGWWGMMMMGMG
WWGGGGMGGGMGWWWGGWGGWGGWWGGMMMMMGGGMGMGGGGMGGWWWGMMGGMGGM
WWWGMGMGGMGGWGWGWWWWWGMGWWWGGGMMMMMGMGGMGWGGGGWWGGMMGGGMM
WWWGMGMGGMGWGMGGWWGWWGGGWWGGMMMMGGMMMGGGWWGWGWWGGWGGMMMMM
WWWGGWGGMMGGGGWWWWGWWWGGWWWGGGGMGMGGGWWGWWWWWWWGGGGMMGGMG
WGGMGGMMGMGWGGGGWGWGWWWGWWWWGMMMMMGGGGWGGGGGGGGGGGWGGGGGW
WWGGMMGGMGGGMGGWWGWWWWWWGGWGGMMGMGMGWGWGGWGWGMMGGGGGGWWWW
GGMGMGWGMGMGMGGGGGGWWWGWWWWGMMGGMGMGWWGWWWGGGGMMMMMGWGWGW
GGMMGWWGGMGGGGGMGGWGGWGWWWWWGMMGMMGWWGGWWGMMMGGGMMMMGWWWW
MGGMMGWWGMMGGWGMGGWGWGWWWWGWGGGGGGWGWGGWWGGGMGGGMMMGWWWWG
MMGMMGWGWGGWWGWGGWWGGWWGWWWGGWWWGWWGGWGWWGGGMGGGGMMMGGWGM
MGWGGWWGGGMGWWWWGWGWWGGGWWWWGGWWWWWWGWWGWGGMMGGGMGGGWGWWG
MGWGGGGGWGMGWWWGMGWGWGGWGGWGGWWWGWGGWGWWGWGGGMMGMMGGGWWWG
GMGGMMGWWWGMGGWGMGGWWGWWWGWGWWWGWWGGGGWWGWGWGMGMGGWWGGWGG
GMMMGMGWGWGMMGWWGGWWGWWGGWGGGWWGWGGWWWGWWWWGGMMGGGGGWGWWW
GGMMMMGWGWGGGWWGGGGWWGGGWGWGWWGGWGWWGGMGWWWGGMGMMGGWGGWWW
GMMGGMGGGGWWGGWGWGGGWGMGGGGGGGMGGGGGWGGWGGGWGMMMMGGGWWWGG
MMMGGGGGGGGWWWWGGWGWWGMMGGGGWGMMGGWGGMMGWWGGGMMGGGGGWGWWG
GGMMGWWWGGWGGWGWWWGGWGGGMMMMGGMMGGWGGGMGWWGWGGMMMMGGGWGGM
MGGGGWWGGWWWGGGWGWWWWWWWGGMMMGMMMGWGMMGGGWWWWWGGGMGWWGWGM
MGMGGWWGWWGGGWWGGWWWGGGWWWGGMMGGGGWGMMMMMGGWGGGGWGGWWGGWG
GGMMMGGGWGWGGWGGMGGGGGGWWGWGMGWWWWWGGMGMGGWWWWGWWWGWWGGWW
MGGGMMGWGGWWGGGWGGMMGWWWGMGGGWGGWGWWGGGMGWWWWWGWWGWGGWGWG
GGMGMMMGGWWGMGGWGGMMMGGWWGGMGWWGWWGWGGWGWWGWGWGWWGGGGWGGW
WGGMGMGMGGGWGMMGMMMGMMMGWGWGWGWWWWGGGWWWGWWGGWGGGWGGWWGWG
GGMMMMGGWGGWGGMMGGMGMMMGWWWGGGGGWGGMGWGWWGWWGWWGWWGWWWWWW
WWGMMGWGWGGGGMMMGWGMMGGMGWGWGWWGGMMGWWGGWWGGWWWWWGWWWWGWG
WWGMGWWWWGMMGMGGMGMGMGMGGGMGMGWWGMMGWGGWWWWWGGWWWWGWGGWWG
