WGGMMMGMMMMMMMMGGGGGMGGWWGMGMMMGMGWWGWGMGWGGMMGMGMMGGMMGG
WGWGMMMGMGGGGMGMGGWGMGGGWWGMGMGGGGGWGWGMGWWGGGMMMMMMGMMMM
WWGGMMGGGGGMGMMGWGGMMMGMGGWGGGMMGMMGWWWGWGGWGGMMMGGGWGGMM
GGGMMMMMGWGGGGMMGWGMMMMMGGWGMMMMGGMGWGGGWGMGMMGGMMMGWWWGG
GGGMGMMGGWGWWGGGGWGGGMGMMGGGMGMGGWGGGMGWGMMMGGGMMMGWWGGWG
MGMMMMMMGWWGWGGWWGWWWGMMMMGMGGMMMGMMMGWGMMGMGGGGGGGWGGGWW
GMMMGGMMGWGGGWWGWGWWGGMGMGGGGMMGMMMGMGGGGGGMGGMGMGGWWGWWG
MGMGWGGGWWWWGGWWWGWGGGMGGGGGWGGGGGMGGWWGMGMMGGGGMMMGWGWWW
MGMGWWGWGGWWWWWWWWWGGWGGMGGGGGWWWGGMGGGGMGMMMMMMMMGMGGGGW
GMGWWGWGWWGWWGGGWGGGGWWWGWGWWWWGGWGGGMGMGGGGMMMGMGGGMGMGW
MGGWWWWGWWGGWGGGGGGWGGWGWWGGWGGWGGGMMMMMGGMGMMMMMGGGMGGGW
MMMGGGWWWWGWGGWWWGGWGWGWWGGGWGGWGMGGMMMGMMMMMMMMGGMGMMGGW
GGMMMGGWWWGWGWGGGGGGWGWGWGGGWWWGGMMGMGGGMMMGGGGMGGMGGGWGW
GMGGGGGWWWWWWGGMGWGWGGWWGGWWWWGGGGMMGGMMGMGMGGMGMGMMGGWGW
GMMMGGGWWGGWWGWGGGGWWWGWGWWWGGGMMMMGMMMMGMMGGMMMMGGMGGGGG
GMMMMGGGWWGWWWWWWWWGWWGWGWWWGGGMGMMMMMGGMMMMMMGMGWGGGWGMM
MMMMGGMGWGWGWGWGGWWGWGGWWGWWWWGGWGGMGMMMGMMMMGGMGGWGWGGMM
GMGGWGMGGWGWWWWWWWGWWWWWWGWGWGGWWGMMMGGMGGMMMMMMGWWGGGWGM
GMGMGMMMGWGGGWGGGWGGGWWWWWWGWWWGWWGMGMGMMGMGGMGGWGWWWWWGM
WGWGGGMGMGWGWGMGWWWWWWWGWGWGWGGWGGGGWGGGGGMGWGMGWGGGGGGGG
GGWGGMMMMGGWWWGGWWGWGGWWGGWGGGWGWGWWWWGGGGGGWWGGWGMGMGGMM
GWWGGMMMMMGGWWWGGWGWGMGWGGWGWWWWGGWWWWGGWWGMGWWWGMMGGGGGG
MGWGGGGMMGMGGWGMGGMGMMMGGWGGGGWWGGWGWGGGWWWGWWGGMGMMMGGGG
MMGGWGWGGMMMGGMMMMMMMMMMGGWGMMGGGMGWWWWGGWGGGWWWGMMGGMMMM
GMMMGMGWGGMGMMMGGGMMGMMGMGGGMGMMGGGGGGGWGGWGGWGGGMGGGMGGG
MGGGWGWWWWGMMMGGGGGMGGMMMGMMGGMGMGGMMGGGWGWWGGMMGGWGGGWWW
GGGGWWGGGGMMGMGGGWWGGMMGMGMMGMMMGMMMMGWGWGWWWGMGWWGWWGWGG
GWGMGWGGGGGGWGWWGWWWGMMMMMGGMGMMMGGGGGWWWWWGWWGGWWWWWWWGG
