MMMGGWGGWGGMGGGMGMGGWGWGWWWGWGGGWWGGGMMGMMGGMGWWWGWGGWWWG
MMMMMGGMGGGMGGMMMGWWWGWWGWGGWWWWWGGMGMMMGGMMGGGGGWWGWWWGG
MGGMGMMMGWGGMMGMGWGWWGGGGGWWGWWGWWGGGMGMMGGMMMMMGWGGGGGWW
MMGMGMGGMGGGMMGGGGGWGGWWGWGGWWWWGWGWWGMGMGMMMGGGGWGGGMMGG
GGGMGMGGGMMGMGWGMMGWGWWGGWWGWGWWWWGGWWGMMMMGMGMMGWWWGGGWW
WGGMGGMMGMMGGGGGMGGWGGWWGGWWWWGWWWWWGGMMMMGMMMMMGGWGGGGGW
WWWGGMMGGGMMGGGMMGMGGWWGGWWWWWWWWWWGGGGMMMMGMMGMMGGMMMGGG
GGGGGGGMMMGMGWGGMMMMGGWWWWWGGWGWWWGGMGWGMMMMMMGMGWGGMMGWW
WGMMMGMGMGMGMGMGGGMGWWGGWGWGMGWGGGWGMMGMGGMMGMGGWWGGGGGGG
GGGMGGMGMMMGMGGMGGMMGGMGGGGMGGWWGMGWGMGGGWGMGGGMGGWGMGMGM
MGMMGWGWGGGMMMGMGMGMMMMGGMMMMMGWWGWGMGGGGWGGMMMGGMGMMGMMM
MMGGGWGGGGMGMMMGGMGMMGMGGGMGGGGWGWGWGWWWGWWGMMGWWGMGGMMMG
GGWGWGWGGMMMMMMGMMMGGMMGMMMGWGMGGWWWGGWWGWGGGGGGGWGWGMGGG
WWWGGGWWWGMMMMGGMMGMMMMGMMGMGMGMGGGWWWWGMGGWWGMGMGGGGMMMM
GGWGWWWWGGGMMGMGMMGGGGMMGMGMMGGMGMGGGGGGMGGWWGMMGGWGMMGMM
WGWGGWWWWWGGMMMGMGMGMMGMMMGGGGGMGMGGWGMGGGGWGGGMGGGWGGGGG
GGWGWGGWGWGWGMGGGGGMMGGMMGMGMMMGMGGMGMGGWWWWWWGGGWGGGWWWG
MGGGWWGGGWGGWGWGWWGMGMMGMGGMGMGGMMMGWGGWWGWWGWGWWGGMMGGGG
GGGWWWWGGWWWWGWWWGWGMGGWGWWGMMGGMMMGGWWGWGGWGGWWWGMGMGWWW
GMGGWWGMMGGGWWWGGMGMMGMGGGGWGGMMMGGWGWGGWWGWWWWGWWGGGWWWW
GMMGGGWGGGGGWGWGMMGGGMMGWWWWGGMGMMMGGWWGGWGGWWWGWGGWWWWWW
MGMGMGGWGGGGGWWWGGGMMMMGWGWGMGMMGGMGGWWWGGGWGGGGWWGGWWGGG
MMMMMGWWWGGWWGWGGGMMMMGWWWGWGWGMMMGGGGWGMMGGGGGWGWGWWWGWW
GGMMGMGWGWWGWWGGWGGGMGWGGWGGMGGMMMMMGGGWGMMMMMGWWGWGWWGWG
GWGMGGGWGWGWWWGMGMGMMGWWWWGGMMMMMGGMMMGGWGGMGMGWWWGGWWGGW
GWWGGWWGMGWWWWWGMMMMGMGGGWGMMMGMMMGGMMMGWWGMGGWWWWGWWWWGW
WGGWGWWWGGWWGWWGGGGGMMGGGGMMMGMMMMGWGGMGGWGGWGWWGGWWWGWGW
GWWWWWGGMGWWWWWGWWGWGGWGMMGGGGMMGGWWGGMMGWGWGWWGWWWGWGGGG
