MMMMMGWGMGMGMGGWGMGGWWWWWGGWWGMGWGMMGWGWGGWWWGWWWWWGGGGMM
GGMGMMGMMGMGMGGWWGWWWGWWGMGGWGGGGMMGWWWWWGGGWGGWWGGGWWGGM
WGGGGMGGGMGGGWWGWWWWGWWGWGGWWWWWGMGGWWWWGGGMGGWWWGWGWGGGM
GWWWGMMGGGWGGGWWWWWWWWGWGGWGGWWGMGWGWGWGGWGMMMGWWWWGWGMMM
GWGGGGMMGWGWWWGGWWGWWWGGWWWWGGWWGGWWGWGMGGMMGMGWGWGWGGGMM
MGGGMMMMGWGWWGGWGWGWGGGMGWGGMGGGWGGGMGMMMGMMMGGWGWWWWWWGG
GGGMGMMGGWGGGGWWGWWWWWGMGWGGGGWGGWGMMGGMMMMMMGWWGWGGWWWGG
WGMMMGGGGWWWGGGGGWGGWGWGWWGGWGWGWGWGGGGGMMGGGGGWGGGGGGWGG
GGGMMGMMMGGWWGWWGWWWGWGMGWWWWWWWWWWWGMGGMGGWWWWWGGGGWWWWW
MGMMGMMGMGWWWWWWWWGWWGGMMGGWGGGGGWGGMMGGGGWWGGGGWWGGWGWWG
MGGMGMMMGGWGWWWWGGWWWWGGMGWWWGWWWGWWGMGMGGWWWWWWGGGWWWWGM
MMGMMMMMMGGWGGWWGWGWWWWGGWWWWWWWGGWWGGGMGGWWGWGWGGWGGGGGM
GGGMMGMMGGGGGWGGWGGWGGGWWWGWGGGGMGGGMMMMGGWGWWGGMMGGWGWWG
MGGGMMMMMMMMGWWWWWWWGGGGWGWWGMMMGMGMGMGMGWWGGGGMMGGWWGGWW
GGGGGGMMMMMGMGWGGWGWWWWWWGGWGGGGMGGMGMMGGWWWGGMMGGWWGWWWG
WGGGWGGGGGMMMMGGMGWWWWGWGGMGMMMMMGGMMMMMGGGWWGGMMGGWGWGGG
GGGWGWWGWGMGMGGGGGWGWWWWWGMMMMMGGGMMMGGGWWGWWWGMGWGWWGMMM
MGGWWGGGGMMMGMGGGWWWWWGGWWGGGMGMGGGMGGMGWWWWWGGGMGMGGGMGM
MGGGWWGMMMMMMMGWWWWWGWWWWGMMGGGGGGGMMMMMGWGWGWWWGGGGWWGGG
MGWGGWGGMGGGMGWWWGGGGWGWGMGMMMMMMMMGMMGMGWGGGGWWGMGWWGWWW
GMGMGWGMMMMGMGGGWGWWGWWGMGGGGMGMGMGMMGGGWWWWWWGWGGGWGGWWG
GGMGWWWGGMGGGWWGGWWWWWWGMMGWWGGMGGGGMMMMGGWWGWGGGGWWWGGWW
MMMGGWGGGGWGGWGGGWWWWGWWGGGGGGMMMGMMGMMMGGGGWGWGGGGWGGWGG
MMGGWWWGWWGWWWWGWWGGGGGGWWWWGGMMGGGGMMMGWGMMGMGWWGWWGWGGW
MGWWWWWWGWGGGWGWWWWWGMMMGGWWGGMGGWGMGGGMGGMGMMGWGGGWGWGWG
MGGWWWWGWGGWGWGGWGGGWGGGWGWWGMMGGGWGMGGGGGGMGGGWGWWWWWGGW
MGWGGWGWGWGWGWGWGWWWWGGWWGWGGGMMMGGMMGGGMGGGWGWWWWWGGWWWW
GGWWWWWWWWWGGGGGWWGWWWGWWGWWWWGMMGMGGWWGGGMGGWGGWWWWWGWWW
