GGWWGWGGWGWWWWGGWWWGGMMGGGGMMMGMGMGGGMGGWWWWGGWWGWGGWGGWW
WWGWWWWWWWWWGWWGWGWGMMMGGMGGGGMMMMMMMGWGGGWWWWWWWGWGWGWWG
GWGGGGGWGGWGGGWWWGWGGMMGMMMGMGMGGGGMGGGMMMGWGWWGWWWWGWGGG
GWWWWWWWWWWWGWWWWWGGGMGMGGGMMMGGGMMGMMMMGMGGGWGWWWGWWGMGG
GGGWWGWGWGGGWGGWWWWGWGGGGGGGGGGMMMGGMGGMGGGGWGWGGGMGGMMMM
WWWWWGGMGMGGWWWWWWGWWWGMMMMGGGMGMMMMMGGMGGMGGMGWGGGMMMMGG
WWGGWWGMGMMGGGWGWGGWWWGMMGMGGMMGGGGMGGGGMMMMMGGWGWWGGGMMG
GGMGWWGGGGGMMGWWWGMGGGGGMMGGGMGMMGGGWWGWGMGMMGGWGGGMMMMMG
MGGGGWGMGMGGGGGGGMMGGMMMMGMMMGWGGGGWGWGGGGWGGGMGGGGMMGGMG
GMMMMGGGGGMGWWGGWGGGGGMGMGGMGWGMGWWWGGMMMGWGGGMMMMGMMMGMG
WGGGGMMMMMGGGWWWWGMMMGMMMMMGWWGMGGWGMGMGGWGMGGGGMMMMMMGGW
GGWWWGGMGMMGMGWGGGMMGGMMGGGWWGWGWWWGMMMGGGMMGGWGMGGGGGWGG
GGWGGGGMGGGMGGWGGMMMGMMMMGMGWWGWWGGMMMMMGMMGMGWWGGGWWGGWW
GGWWWGGGMGGMGGGGMMMMMGGMGGGGWGGGGMGGMMGMGMMGMMGGGWGWWWGGW
GWWWGWGGMGGMMMMGMMMGMGGMGMGGGWGWWGMMGGGMMGMMMGGWWWGWGGWWW
WWWWWGWGGMGGGMMMGMGGMGGMGMGGWWWWGGGGGWWGGWGGMGWWWWWWWWGGG
GWWWGMGMMMGGGMGGMMMMMMMMMMGGGGGWWWWWGWGWGWGGGWGGWWGGGGGMM
GGWGMGMGMGWWGGMMGMGGGGMGMMMGWWGWWWGGGWGWWGGWWWWWWGMMMGWGG
WGGMMMMGMMGWGGGMMGMGGMGWGGGWGWWGWGGGGGMGWWGWWWWGGGMGGGGWW
GGMGGGMGMGGWGMGGGMMGGMGWWGWWWWWWWGWGGWGGGGMGWGWGGWGGWWGGG
GMMMMGMMGGWWGMMMGGGMGMGWGGGGWWGWWGGWWGGWGMMMGGGGWGGGWGWWW
GGMMGGMMGGWWGGMGWWGGGGWGWWWWWGWGGWWWWWGGGGGGWGGWWGMGGWWGW
MMGMGGMMMGWGMGMGGGGWWGGWGGWWWGGGWWGWGWWWWWWWWWWWWWGMGWGGG
GGGMMGMGGWWGMMGMMGMGGMGGGWWWGGGWWWGGWWWWWGWGWWWWGGGMGWGMG
MGGMGMGGWWWGGGMMMGMMMGWGGWGWGWGGGWWGWWGWGWWGGGGWGWWGWWGMM
MGGGMGGGGGWWWWGMGMMMGGWWWGGWWGGGMGGWWWGGWGWGGGWWGWWWWGMGG
GMMGMMGMMMGGGGGMMMMMMGGWWWGWGWWGGGMGWGWWGMGMMGGWWWWGWGMMG
MGMMMMGMGMMGMMMMMMMMGGGWWGWWWGGMGGGGGWWGGMMGMMMGGWWGGMGMG
